淸廟之什第二十六周頌	周頌三十一篇皆是周室太平德洽著成功之樂歌也名之曰頌頌者誦也容也歌誦盛德序太平之形容以此至美告於神明皆成王周公時作也	_
淸廟	本又作庿古今字也苗笑反廟貌也淸廟者祭有淸明之德者之宫也杜預云肅然淸淨之稱也	_
雒邑	音洛本亦作洛水名字從水後漢都洛陽以火德爲水尅火故改爲各傍佳	_
朝諸侯	直遥反	source
於穆	音烏注同於歎辭穆美也後發句歎辭皆放此以意求之	commentary
顯相	息亮反注同	source
見也	賢遍反下著見同	commentary
駿奔	音峻毛云長也鄭大也下篇同	commentary
無射	音亦厭也	commentary
見厭	於豔反下同	source
德與	音餘下同	commentary
維天之命	韓詩云維念也	commentary
大平	音泰後大平皆放此	_
假以	音暇嘉也	source
溢我	音逸毛愼也鄭盈也徐云毛音謚	commentary
溢愼也	市震反本或作順案爾雅云毖神溢愼也不作順字王肅及崔申毛並作順解也	_
明與	音餘	commentary
乃單	音丹	commentary
成王能厚之也	一本作能厚行之也今或作能厚成之也	_
猶重	直龍反	commentary
維淸刺伐	七亦反	_
緝	七入反	commentary
煕	許其反緝煕光明也	_
肈	音召始也	_
禋	音因祀也徐又音烟	source
迄用	許乞反至也	commentary
之祺	音其祥也爾雅同徐云本又作禎音貞與崔本同	_
烈文	烈光也	commentary
以朝	直遥反	source
辟公	音璧注下皆同	commentary
祉福	音恥	commentary
無疆	居良反竟也	commentary
傳世	直專反	_
累也	劣僞反下同	source
訓道	音導	commentary
天作謂大王	音泰後大王大祖皆同	_
諸盩	直留反又音侜	commentary
不窋	陟律反	commentary
岐山	其冝反	commentary
道	音導	commentary
岍	口田反又口見反	commentary
自豳	彼貧反	commentary
之行	如字道也王徐並下孟反	commentary
夷易	羊豉反下徐易曰皆同	commentary
佼易	古卯反	source
乾以	其連反	commentary
巛以	苦魂反字亦作坤	_
訂大王	待頂反沈又直丁反說文云評議也譜云參訂時驗謂平比之也字詁云訂平也	source
昊天有成命成王	王如字徐于況反	_
其命	音基本亦作基始也	_
宥密	音又寛也	commentary
王功	于況反	commentary
敢解	音懈下同	_
止苛	音河	commentary
刻也	音克	commentary
單厥	都但反厚也注同	commentary
我將	如字毛云將大也鄭云將奉也	commentary
我享	許丈反徐許亮反	commentary
右之	音又注及下同本亦作佑	commentary
肥腯	徒忽反說文云羊曰肥豕曰腯	commentary
伊嘏	古雅反毛大也鄭受福曰嘏	commentary
時邁	邁行也	commentary
巡	音旬	_
守	手又反本或作狩注同	commentary
柴望	士佳反說文字林作祡	commentary
巡行	下孟反下出行同	_
封禪	市戰反	commentary
徧于	音遍	commentary
實右	音又注同助也	commentary
震疊	徒恊反懼也	source
懐柔	如字本亦作濡兩通俱訓安也	_
喬	音橋髙也	commentary
●	本亦作嶽同音岳	_
賢知	音智	commentary
載戢	側立反聚也	commentary
載櫜	音羔韜也	commentary
韜也	吐刀反	commentary
不復	扶又反	source
肆于	音四	source
時夏	戶雅反大也注同	source
執競	其敬反執持也競強也韓詩云執服也	commentary
大功	本或作天功	commentary
斤斤	紀覲反明察也	commentary
喤喤	華彭反和也徐音皇又音宏注同	source
磬筦	音管本亦作管同	_
將將	七羊反集也注同說文作蹡蹡行貌	commentary
穰穰	如羊反衆也	source
反反	如字毛難也鄭順習貎沈符板反又音販	commentary
反復	扶又反重也又音服	source
以重	直用反	source
思文烝民	之丞反衆也	_
作粒	音立	commentary
阻飢	莊呂反難也馬融注尚書作祖云始也	source
作艾	音刈鄭注尚書五蓋反本或作乂音同	_
貽我	音夷字又作詒同遺也	source
來牟	並如字牟麥也字書作麰音同牟字或作●孟子云●大麥也廣雅云麳小麥麰大麥也	source
疆爾	居良反竟也	commentary
介	音界大也後放此	commentary
時夏	戸雅反注同	commentary
遺也	唯季反下同	_
出涘	音仕	source
以燎	力召反	commentary
封竟	音境本或作境	commentary