那第三十商頌	商者契所封之地名成湯伐桀王天下遂以爲國號後世有中宗髙宗中興時有作詩頌之者當周宣王之時宋大夫正考父校商之名頌十二篇於周之大師以那爲首歸而祭於先王孔子録詩之時止五篇而巳乃列之以備三頌	_
那祀	乃河反多也	source
微子	名啓紂庶兄周武王封之於宋爲殷後	source
正考父	音甫本亦作甫宋湣公之曽孫孔子七世祖	commentary
大師	音泰後大甲大古大戊大祖皆放此	commentary
朝聘	直遥反	commentary
曲折	之設反	source
猗	於冝反歎辭也	commentary
與	音余下同	source
置我	毛如字殷人置鼓鄭作植字時職反又音值爲楹貫而樹之	commentary
鞉鼓	音桃小鼓也	_
夏后	戸雅反注同	source
縣鼓	音玄下同	_
爲楹	音盈柱也	commentary
貫而	古亂反	source
作濩	戸故反殷湯樂曰大濩	_
衎我	苦旦反樂也	commentary
奏假	毛古雅反大也鄭作格升也	source
衎樂	音洛下以樂我同	_
齊之	側皆反本亦作齋下同	commentary
所耆	市志反	commentary
所為	于偽反	_
僾然	音曖	commentary
愾然	苦代反	commentary
淵淵	古𤣥反又烏𤣥反	commentary
嘒嘒	呼惠反和也	commentary
依倚	於綺反	commentary
於赫	音烏注同	commentary
庸鼓	如字依字作鏞大鍾也	_
有斁有奕夷繹	並音亦繹字又作懌同	_
有恪	苦各反敬也	commentary
夷說	音恱下同	commentary
𧲛	牋鍊反本又作薦同	_
饌	士戀反	commentary
烝嘗	之丞反	_
烈祖	烈祖有功烈之祖	commentary
復興	扶又反下亦復同	commentary
斯祜	音戶福也	commentary
無疆	居良反竟也下同	commentary
清酤	音戶酒也	commentary
賚我	毛如字賜也鄭音來	commentary
申重	直用反下皆同	commentary
王天下	于況反	source
無竟	音境本亦作境	commentary
以祼	古亂反	commentary
致齊	側皆反本亦作齋	commentary
鬷	子東反緫也	source
假	毛古雅反大也鄭音格至也下以假以享同	commentary
有爭	爭鬬之爭注同	commentary
綏我	音妥安也	commentary
黃耉	音苟	_
緫也	音㧾	_
調腥	音條	commentary
祼	音灌	commentary
約軧	祁支反轂飾也諸侯助祭者乘篆轂金飾錯衡之車駕四馬故曰軧	_
錯衡	如字徐又采故反	commentary
鶬鶬	七羊反本又作鏘言文徳之有聲也	commentary
溥將	音普	commentary
穰穰	如羊反	commentary
轂飾	古木反下音式	commentary
在鑣	彼苗反	commentary
篆轂	直轉反	_
來朝	直遥反	commentary
來假	音格鄭云升也王云至也	commentary
玄鳥	玄鳥燕也一名鳦音乙	commentary
祀髙宗	毛王如字鄭作祫戸夾反三年喪畢之祭也髙宗殷王武丁也	commentary
雊雉	古豆反	commentary
之異	尚書云髙宗祭成湯有飛雉升鼎耳而雊是也	commentary
復興	扶又反	commentary
於契	息列反殷之始祖也本又作偰同又作禼古字也後放此	_
古者喪三年旣畢祫于大祖明年禘于羣廟	一本作古者君喪三年旣畢禘于其廟而後祫祭于大祖明年春禘于羣廟案此序一注舊有兩本前祫後禘是前本兩禘夾一祫是後本也	_
芒芒	莫剛反大貌後同	commentary
有娥	息忠反契母之本國名	_
郊禖	音梅本亦作髙禖	commentary
遺卵	力管反	_
居亳	傍各反地名	commentary
正長	張丈反下同	commentary
徧告	音遍	commentary
不解	音懈	_
武王	于況反又如字注同	source
不勝	毛音升任也鄭式證反	commentary
十乗	繩證反注同	source
大糦	尺志反黍稷也韓詩云大祭也	commentary
勝任	音壬下何任同	commentary
大國與	音余	_
畿疆	居良反	commentary
來假	音格至也下同	commentary
祁祁	巨移反或上之尺之二反	commentary
景貟	毛音圎均也鄭音云	_
維河	鄭云河之言何也王以爲河水本或作何	source
是何	音河河可反本亦作苛音同毛云任也鄭云擔負也下篇何天同	commentary
來朝	直遥反	commentary
擔負	都藍反下篇同	commentary
長發	如字久也	commentary
大禘	大計反鄭云大禘者郊祭天也王云殷祭也	commentary
王者	于況反又如字	commentary
濬	音峻深也	commentary
悊	音哲字或作哲	commentary
芒芒	音亡依韻音忙	commentary
是疆	居良反竟界也	source
幅	方目反廣也	commentary
隕	音圎毛均也鄭周也徐于貧反	source
諸夏	戸雅反下皆同	commentary
作圜	音還又音圓	commentary
深知	音智	commentary
發見	賢遍反	commentary
禎	音貞祥也	commentary
其竟	音境	commentary
王天下	于況反下湯王言王之王德皆同	commentary
桓撥	本末反治也韓詩作發發明也	commentary
徧也	音遍下同	commentary
政治	直吏反	commentary
相土	息亮反注相土皆同相土契孫也	commentary
有截	才結反整齊也	commentary
出長	張丈反	commentary
湯齊	如字	source
浸大	子鴆反	source
日躋	子兮反升也鄭注禮記讀上爲湯躋讀此爲日齋齋莊也	commentary
昭假	古雅反鄭云暇也徐云毛音格鄭音暇案王肅訓假爲至格是王音也沈云鄭箋云寛暇此以義訓非韓字也	source
是祗	諸時反	commentary
下土	遐嫁反	commentary
小球	音求美玉也下同	commentary
綴旒	陟劣反徐又張衞反毛云表也鄭云結也二同	commentary
之休	虚虯反美也	source
珽	吐頂反天子玊笏長三尺杼上終葵首	commentary
長三	直亮反	source
旒縿	所銜反	_
著焉	直略反	source
歸郷	本亦作嚮許亮反下篇同	source
不絿	音求徐音虯急也	commentary
是遒	子由反反在由反聚也	commentary
小共大共	毛音恭法也鄭音拱執也一云毛亦音拱	commentary
駿	音峻毛大也鄭俊也又一云毛亦作俊讀	commentary
厖	莫邦反厚也徐云鄭音武講反是叶拱及寵韻也	commentary
之龍	毛如字和也鄭作寵	commentary
傅奏	音孚本亦作敷	_
不戁	奴版反恐也	commentary
不竦	小勇反懼也	commentary
是緫	子孔反本又作音宗	commentary
恐也	曲勇反	_
驚憚	丹末反	commentary
載旆	蒲貝反	_
秉鉞	音越	commentary
得中	張仲反	commentary
三蘖	五葛反餘也韓詩云絶也	commentary
韋顧	二國名也漢書古今人表作韋鼓	commentary
已姓	音紀又音𣏌	_
中葉	如字又張仲反	commentary
橈敗	女敎反一音女卯反亂也	commentary
實左	音佐注同	source
右	音又注同左右助也	commentary
阿倚	於綺反下同	commentary
殷武撻彼	他達反疾也韓詩云達也	_
罙入	面規反毛深也鄭冒也說文作䍘從冈米云冒也	commentary
其阻	莊吕反險也	commentary
裒荆	蒲侯反聚也	commentary
冒也	莫報反下同	_
之隘	於懈反窄也	commentary
而俘	音孚囚也	commentary
猶處	昌慮反下同	_
氐	都啼反西方夷狄國	commentary
世見	賢遍反	_
而背	音佩	source
多辟	音璧下同君也注放此王音僻邪也	commentary
禍適	直革反徐張革反注同過也韓詩云數也	commentary
匪解	音懈注同	_
來朝	直遥反	commentary
不僭	子念反	commentary
王天下	于況反	commentary
重吿	直用反	_
是斷	音短注同	commentary
方斵	陟角反說文云斫也	commentary
是䖍	其連反椹也爾雅作榩	commentary
松桷	音角	commentary
有梴	丑連反又力鱣反長貌柔梴物同耳字音鱣俗作	commentary
易直	以豉反下同	commentary
椹	陟金反	commentary
掄材	魯門反擇也沈音倫理也	_