聖治章聖	從王正從王非	_
之行	下孟反	source
則周公	周公名旦文王之子武王之弟	source
祀	音似	commentary
后稷	上音後稷官名后社名弃周公之始祖也	source
故異其處	昌慮反	_
辟后稷也	音避本亦作避同	_
於朝	直遥反	_
越嘗	逺國也	_
重	直龍反	source
譯	本亦作驛同音亦自故異字至音亦本今無	_
夫	音符	_
膝	辛七反從木入水桼音七正	_
以養	羊尚反	_
父母日嚴	人實反注同日者實也日日行孝故無闕也象日	_
致其樂	音洛下樂同	_
親近	附近之近	_
於母	自致其樂至於母本今無	_
其政不嚴而治	直吏反	_
不令	力正反	_
而行	自不令至而行本今無	commentary
父子之道	古文從此巳下別爲一章	commentary
續	音俗相續也	source
焉	本今作莫	commentary
大焉復	扶又反	_
何加焉	自復字至焉本今無	_
故不愛其親	古文從此已下别爲一章	source
謂之悖	補對反注下同	commentary
德若桀	其烈反	_
紂	丈久反	_
是也言中詩書	丁仲反下同自若字至下同本今無	_
行思可樂	如字音洛注同	commentary
難進而盡	津忍反	_
中易	以豉反	_
退而補過	古臥反	_
效	户教反	_
漸也不令	一政反下文並注並同	_
而伐謂之暴	蒲報反自難進至報反本今無	_
詩云	此詩曹風鳲鳩之篇語	source
淑人	常六反	commentary
其儀	字從人	source
不忒	他得反差也	commentary