䷂屯	張倫反難也盈也坎宫二世卦	_
則否	備鄙反	commentary
得主則定	本亦作則寧	commentary
而難	乃旦反卦内除六二注難可餘並同賈逵注周語云畏憚也	commentary
天造	徂早反注同	commentary
草昧	音妹廣雅云草造也董云草昧微物	commentary
而不寧	而辭也鄭讀而曰能能猶安也	commentary
經論	音倫鄭如字謂論撰書禮樂施政事黃穎云經論匡濟也本亦作綸	_
磐	本亦作盤又作槃歩干反	commentary
桓	馬云槃桓旋也	commentary
晏安	本又作宴各依字晏一諫反宴一見反	_
下賤	遐嫁反	commentary
屯如	子夏傳云如辭也	commentary
邅如	張連反馬云難行不進之貌	commentary
乗馬	繩證反四馬曰乗下及注並同鄭云馬牝牡曰乗子夏傳音繩	commentary
班如	如字子夏傳云相牽不進貌鄭本作般	commentary
媾	古后反馬云重㛰本作冓鄭云猶會本或作構者非	commentary
相近	附近之近下近五同又如字	commentary
即鹿	王肅作麓云山足	commentary
君子幾	徐音祈辭也注同又音機近也速也鄭作機云弩牙也	commentary
如舎	式夜反止也注下同徐音捨	commentary
往吝	力刃反又力愼反馬云恨也	commentary
雖比	毗志反下皆同	commentary
之易	以豉反	commentary
不揆	葵癸反	commentary
以從	如字鄭黃于用反	commentary
合好	呼報反下同	source
恢弘	苦回反大也	commentary
博施	式豉反及下文皆同	source
拯	拯救之拯	commentary
亨于	許庚反	source
他閒	閒厠之閒	_
漣如	音連說文云泣下也	commentary
應援	于眷反又音袁	commentary
闉	音因塞也春秋傳云當陳隧者井堙木刋是也	commentary
厄	於革反又於賣反	commentary
委仰	如字又魚亮反	commentary
長也	直良反	_