周易雜卦	韓云雜糅衆卦也孟云雜亂也	source
第十一雜糅	如又反	_
比	毗志反下同	source
樂	音洛注同	source
臨觀	古亂反	commentary
屯見	賢遍反注及下皆同鄭如字	commentary
經綸	本又作論音倫又力門反	commentary
上升	時掌反下文離上并注同	source
豫怠	如字姚同京作治虞作怡	commentary
則飭	音敕注同整治也鄭本王肅作飾	commentary
剥爛	老旦反	source
晝也	竹又反	commentary
誅也	荀云誅滅也陸韓云傷也	commentary
解	音蟹	source
難也	乃旦反	commentary
衆	荀作終	source
去故	起吕反	commentary
豐多故	衆家以此絶句	commentary
親寡旅也	荀本豐多故親絶句寡旅也別爲句	commentary
道長	丁丈反	commentary
周易畧例	此是輔嗣所作旣釋經文故相承講之今亦隨世音焉或有題爲第十者後人輒加之耳	_
明彖動不能制動	一本作天地不能制動	_
貞夫	音符後皆同	_
琁	悉全反又作旋	_
璣	音機本又作機或作幾	_
輻	音福	_
湊	干豆反	_
則思	息吏反	_
可逺	于万反	_
能渝	羊朱反	_
至賾	仕責反	_
能與	音預	_
觀喙以斯	一本作以彖觀之	_
明爻通變好靜	呼報反	_
度量	音亮	_
朝	直遥反	_
廷	音定	_
必比	毗志反	_
隆墀	本又作坻直其反坻螘冢	_
逺壑	火各反	_
而濟	一本作而載	_
能說	音恱	_
善邇	善又作繕	_
愛惡	烏路反次章同	_
語成而後有格	舊本如此一本格作括	_
能與	音豫	_
明卦適變通爻	本又作明卦通變適爻又一本直云適變通爻	_
否泰	備鄙反	commentary
險易	以豉反章内同	_
於斷	丁亂反	_
要其	一遥反	_
辟險	音避本亦作避後章同	_
比復	毗志反	_
好先	呼報反	_
侮妻	亡甫反	_
故當	如字	_
其介	音界本又作分符問反	_
明象觀意	本亦作見意	_
猶蹄	音啼	_
在兔	他故反字又作菟	_
筌者	七全反筌蹄事見莊子	_
重畫	直龍反下胡麥反下同	_
應健	音鷹	_
滋漫	末半反	_
縱復	扶又反	_
辯位繫辭	戸計反下同	_
位分	扶問反下同	_
去初	羌吕反	_
無六爻	無亦作損	_
畧例下	舊本如此本或無下字	_
率	音類又音律又所律反	_
相比	毗志反	_
險易	以豉反	_
之行	下孟反	_
去六	羌吕反	_
見咥	直結反	_
所怨	紆万反又紆元反	_
卦畧	凡十一卦	_
屯難	乃旦反遯明夷卦同	_
所馮	皮冰反本亦作憑	_
蒙隂昧	音妹	_
不諮	本亦作資	_
四逺	袁万反觀明夷卦同	_
初比	毗志反	_
履不處	謂陽爻不處其位爲美	source
履者禮也	今雜卦無此句韓注有或傳寫者誤	_
臨剛長	丁丈反遯卦同	_
觀	古亂反	_
以所見	一本所作知	_
以近	附近之近明夷卦同	_
大過棟橈	乃孝反	_
拯弱	拯救之拯	_
同好	呼報反	_
所贍	常豔反	_
褊矣	必淺反	_
遯浸	子鴆反	_
長	張丈反	source
難在	乃旦反	_
亨在	許庚反	_
大壯觸	昌録反	_
蕃	扶袁反	_
明夷最逺	于万反	_
最近	附近之近	_
而難	乃旦反	_
能溺	寧歷反	_
睽最見	賢遍反豐卦同	_
洽乃	咸夾反本又作合	_
豐惡闇	烏路反	_
之沛	歩貝反又普貝反	_
之蔀	歩口反	_
明昧	音妹本亦作妹又作沬皆末貝反下文同	_
無與	如字又音預	_
折其	之舌反	_