僖公上	名申莊公之子閔公之兄母成風諡法小心畏忌曰僖	source
第五杜氏盡三十三年經元年聶北	女輒反	_
觀釁	許覲反	commentary
于檉	勑呈反	commentary
于酈	力知反	source
莒挐	女居反又女加反	commentary
傳元年復入	扶又反下文同	_
常準	之尹反	_
人潰	戸内反	commentary
撰具	仕眷反又仕轉反	commentary
分災	甫問反又如字	commentary
州長	丁丈反	commentary
于犖	音洛又力角反	commentary
虚丘	起居反	commentary
要而	於遥反	commentary
爲魯	于僞反	source
重來	直用反	commentary
無厭	於鹽反	commentary
汶陽	音問	source
及費	音祕	commentary
萊蕪	音來	commentary
經二年大陽	音泰一音如字	_
見經	賢遍反	commentary
于貫	古亂反	commentary
貰城	市夜反又音世	source
傳二年屈産	求勿反又居勿反注同	_
之乗	繩證反注同	source
宫之竒	其冝反	commentary
懦	本又作燸乃亂反又乃貨反弱也字林愞音乃亂反偄音讓丈反云弱也	commentary
強諫	其良反又其丈反	commentary
且少	詩照反	commentary
長於	丁丈反	commentary
暱之	女乙反	source
顚軨	音零	source
伐鄍	亡丁反	source
坂	音反	commentary
以說	音恱	commentary
聚抄	初敎反又楚稍反強取物	_
賄故	呼罪反	source
惡貪	烏路反	commentary
故爲	于僞反下同	commentary
寺人	如字又音侍寺人奄官名	commentary
貂	音彫	commentary
豎貂	上主反	source
擅貴	時戰反	commentary
漏洩	息列反又以制反	source
必易	以豉反	commentary
五稔	入甚反熟也	commentary
耼伯	乃甘反	source
侵掠	音亮	commentary
經三年下邳	皮悲反	_
僮縣	音童	commentary
廬江	力居反	source
涖盟	音利又音類臨也	commentary
傳三年夏六	戸雅反	_
爲陽榖	于僞反	source
鄭難	乃旦反	commentary
于囿	音又苑也	source
經四年于陘	音刑	_
召陵	上照反傳皆同	commentary
陳袁	袁陳大夫氏也本多作轅	_
濤塗	音桃	source
與謀	音預下同	commentary
傳四年所近	附近之近	_
大公	音泰注同	commentary
公奭	音釋	commentary
女實	音汝	commentary
夾輔	古洽反舊古協反	commentary
以夸	苦瓜反	source
無棣	大計反	commentary
齊竟	音境下皆同	commentary
不共	音恭本亦作供下及注同	commentary
以縮	所六反	commentary
裹束也	音果	commentary
菁茅	子丁反	commentary
苞匭	音軌本或作軌苞或作包	commentary
巡守	手又反	source
而溺	乃歷反	source
水濵	音賔	commentary
故復	扶又反	commentary
完乗	繩證反注同	commentary
是爲	于僞反注同	commentary
之好	呼報反下及注同	commentary
謙稱	尺證反	source
徼福	古堯反要也	_
漢以爲池	本或作漢水以爲池水衍字	_
葉縣	始渉反	source
以當	丁浪反	_
之費	芳味反	_
郯莒	音談	_
申侯見	賢遍反	_
資糧	音良	_
屝屨	符費反草屨也	_
齊侯說	音恱	_
以衮	古本反衮冕上公服	_
斂	力驗反	_
不如	依字讀或一音而據反	commentary
其繇	直救反兆辭也	source
渝	羊朱反變也	_
攘公	如羊反除也	_
之羭	羊朱反美也	_
一薫	許云反香草也	_
一蕕	音由臭草也	_
易消	以豉反	_
卓	吐濁反	_
歸胙	才故反祭之酒肉也	_
姬寘	之豉反	_
地墳	扶粉反	_
犬斃	婢世反	_
原款	苦管反	_
必辯	兵免反	_
不樂	音洛注同	_
被此	皮寄反又皮綺反	_
縊于	一賜反	_
遂譖	側鴆反	_
經五年惡用	烏路反	_
𣏌伯姬來	絶句來歸寧	_
朝其子	猶言其子朝	_
越竟	音境	_
自爲	于僞反	_
復稱	扶又反	_
􁉨縣	音犬	_
言易	以豉反	_
傳五年遂登觀	古亂反注同	_
臺以望	絶句	_
而書	本或作而書雲物非也	_
審別	彼列反	_
重申	直用反	_
爲二公子	于僞反下乃爲之請同	_
寘薪	之豉反	_
譴讓	弃戰反	_
焉用愼	於䖍反	_
尨	莫江反又音蒙	_
茸	如容反又音戎尨茸亂貌	_
適從	丁歷反	_
及難	乃旦反	_
寺人披	普皮反	_
不校	音敎	_
乃徇	似俊反	_
踰垣	音袁	_
其袪	起魚反袂也	_
奔翟	音狄	_
袂	面世反	_
取焉	七喻反本又作娶	_
美城之	絶句	_
樓櫓	音魯	_
秋諸侯盟	本或此下更有于首止三字非	_
撫女	音汝	_
以輕	遣政反下同	_
所喪	息浪反	_
侯復	扶又反六年經注同	_
輔車	尺奢反牙車也	_
大伯	音泰下及注同	_
之昭	上饒反注同後昭穆放此	_
唯偪	彼力反	_
吾享	興兩反	_
逺聞	音問又如字	_
繄物	烏兮反是也	_
所馮	皮冰反下注同	_
晉使	所吏反	_
不臘	力盍反	_
童謡	音遥	_
不見	賢遍反	_
均服	如字同也字書作音同	_
振振	音眞注同	_
鶉之	述春反又常倫反	_
賁賁	音奔	_
焞焞	他門反	_
傅說	音恱	_
近日	附近之近	_
巳上	時掌反	_
童齔	初問反又恥問反毁齒也	_
嬉戲	許冝反	_
或中	丁仲反	_
夏之	戸雅反下同	commentary
言易	以豉反	commentary
經六年傳六年郤	去逆反	_
芮	如銳反	source
近秦	附近之近	source
以見	賢遍反	source
各罷	扶罵反又扶買反	commentary
宛縣	於元反	commentary
衰絰	七雷反下直結反注同	source
輿櫬	於覲反棺也	commentary
爲質	如字一音置本又作贄音至	_
其縛	如字舊扶臥反	commentary
而祓	芳弗反徐音廢說文云除惡之祭也	commentary
經七年不厭	於鹽反傳同	_
寗母	如字又音無注同	source
方與	音房下音預	source
泥母	乃麗反又音寗王奴兮反	source
傳七年何憚	徒旦反難也	_
難也	乃旦反此年及八年經傳並同	commentary
請下	戸嫁反	commentary
朝不	如字	source
知女	音汝下皆同	commentary
疵瑕	似斯反又疾移反	commentary
罪釁	許靳反下文同	commentary
政狹	音洽	commentary
洩氏	息列反	source
去之	起吕反	commentary
不奸	音干	commentary
共時	音恭注同	commentary
釁隙	去逆反	commentary
覆亡	芳服反	source
替矣	他計反	_
雖復	扶又反	commentary
介於	音界	commentary
堵叔	丁古反又音者	commentary
可閒	閒廁之閒	_
惡大叔	烏路反大音泰叔又作州	commentary
經八年于洮	他刀反	_
未與	音預下同	source
大廟	音太	commentary
與殺	音試	_
傳八年虢射	食亦反	_
期年	音基本或作朞注同	commentary
不祔	音附	commentary
玆父	音甫	_
目夷長	丁丈反	commentary
經九年御說	魚吕反下音恱	_
不復	扶又反	source
殤	式羊反	source
而笄	古兮反	source
之冠	古喚反	source
相比	毗志反	source
故重	直用反	commentary
不與	音預	source
佹諸	九委反	commentary
殺其君之子	上如字又音弑傳同公羊音試	source
傳九年之稱	尺證反	_
一人釗	古堯反又音昭	source
脩好	呼報反下于好并注同	source
賜齊侯胙	才素反	commentary
耊老	田節反一音他結反	_
加勞	力報反	source
一級	音急等也	source
咫尺	之氏反八寸曰咫	source
顚隊	直類反下同	commentary
以遺	于季反	source
先諸侯	悉薦反	source
復西	扶又反下不復會同	source
㔻鄭	普悲反	commentary
藐諸	妙小反又亡角反	commentary
縣藐	音玄	commentary
無猜	七才反疑也	commentary
焉辟之	於虔反下文焉能克同	commentary
之玷	丁簟反又丁念反缺也	commentary
令不及魯	力政反本又作命	source
今復	扶又反	commentary
重發	直用反	source
從夷吾	才用反	commentary
隰	音習	source
易出易入	並以豉反	commentary
不好	呼報反	source
長亦	丁丈反	source
不僭	子念反下注同	source
鮮不	息淺反	source
無好	呼報反又如字	commentary
無惡	烏路反	source
宋治	直吏反	source
經十年雨雪	于付反	_
傳十年不篡	初患反	_
共大子	音恭本亦作恭大音泰	source
故復	扶又反下文及注同	source
卑秦	必利反下注同	commentary
不歆	許金反饗也	commentary
西偏	匹緜反	source
遂不見	賢遍反又如字	source
所馮	皮冰反	commentary
郤稱	尺證反一音如字	source
泠至	力丁反	source
七乗	繩證反	commentary
左行	戸郎反下同	source
共華	音恭	commentary
騅歂	音佳下市專反	source
纍虎	力追反	source
山祁	巨之反字林上尸反	source
背大	音佩	commentary
焉能	於䖍反	commentary
經十一年踰閾	音域門限也一音況域反	_
傳十一年内史過	古禾反	_
受玉惰	徒臥反	commentary
長世	直良反又丁丈反	_
揚拒	俱宇反	commentary
泉皐	古刀反	_
經十二年陳侯杵臼	昌吕反下其九反	_
傳十二年之郛	芳夫反	_
狄難	乃旦反下同	source
不共	音恭	source
焉能	於䖍反	source
二守	手又反注同	source
始見	賢遍反下同	source
陪臣	歩回反	source
之使	所吏反	source
謂督	音篤	source
凱	開在反本亦作愷	commentary
悌	音弟本亦作弟	source
所勞	力報反注同	commentary
凱樂	音洛下同	_
悌易	以豉反下同	commentary
勞	力報反	commentary
來	力代反	commentary
不復	扶又反	commentary
經十三年濮陽	音卜	_
傳十三年爲戎	于僞反下注欲爲同	_
難故	乃旦反	commentary
戍卒	子忽反	commentary
荐	在薦反重也	source
饑	音飢又音機	source
乞糴	直歷反	source
重施	式豉反下同	source
自雍	於用反秦國都	source
及絳	古巷反晉國都	source
汎舟	芳劒反	source
河汾	扶云反	source
經十四年鄫子	似綾反本或作繒	_
侯肸	許乙反	commentary
傳十四年澶淵	市然反	_
而還	戸關反	commentary
期年	音基	commentary
大咎	其九反	commentary
幾亡	音祈又音機	commentary
背	音佩後皆同	commentary
施	式豉反注及下而施毛十五年皆同	source
安傅	音附	commentary
經十五年牡丘	茂后反	_
不復	扶又反	source
螽	音終本亦作􁈰	commentary
中絶	丁仲反又如字	commentary
己卯晦	音悔	_
于婁	力侯反	commentary
下邳	蒲悲反	commentary
愎諫	皮逼反	commentary
傳十五年諸夏	戸雅反下注同	_
屬賈君	音燭	commentary
詛無	莊據反	commentary
烝於	之承反	source
解梁	音蟹注及下注同	source
詰之	起吉反	source
遇蠱	音古	source
千乗	繩證反	commentary
三去	起居反又起據反一音起吕反下同	source
不孫	音遜注同	commentary
惡其	烏路反	commentary
小駟	音四	source
狡	古卯反	commentary
憤	扶粉反	source
張脉	中亮反注同下音麥	source
僨興	方問反動也	source
三施	式氏反年末注同	source
可狃	女九反	commentary
􁇜也	時世反又時設反	_
還濘	乃定反泥也	commentary
故隋	大果反	commentary
公號	戸刀反王戸報反	commentary
輅秦	五嫁反迎也	commentary
拔舎	蒲末反注皆同	source
厭息	於冉反一音於甲反又於輒反下同	commentary
子罃	於寅反	commentary
履薪	如字徐本作屨九具反	source
抗絶	苦浪反	source
荐之	在薦反	commentary
上下	時掌反	commentary
絻服	音問又作免音同	_
衰絰	七雷反下大結反	source
令行人	力呈反下同	commentary
曰上天降災	此凡四十七字檢古本皆無尋社注亦不得有有是後人加也	commentary
鄠縣	音戸	source
焉用	於䖍反	commentary
以要	於遥反	commentary
重其	直用反下皆同	commentary
難任	音壬注及下同	source
子縶	張執反又丁立反	source
聚慝	他得反後同	source
復相	扶又反	source
質其	音置下注質秦同	commentary
祗以	音支	_
史佚	音逸	source
大史	音泰	source
無怙	音戸	commentary
飴甥	音怡	commentary
爰田	于元反	commentary
孺子	如喻反	source
喪君	息浪反後注同	commentary
輯睦	音集又七入反	source
好我	呼報反	commentary
惡我	烏路反	source
衆說	音恱	commentary
州長	丁丈反下長男同	commentary
之睽	苦圭反又音圭	commentary
其繇	直又反	commentary
士刲	苦圭反刺割也	commentary
無􁀱	音荒血也	commentary
承筐	曲方反	commentary
無貺	音況本亦作況	source
無應	應對之應下無應同	commentary
中女	丁仲反	source
鄰責	側介反又如字	source
可償	市亮反又音常	source
相	息亮反注同助也	commentary
爲嬴	音盈	source
車說	吐活反注同	source
其輹	音福又音服案車旁著畐音福老子所云三十輻共一轂是也車旁著复音服是車下伏菟	source
下縛	如字又扶臥反	commentary
寇難	乃旦反	commentary
之警	音景	commentary
姪其	待結反字林丈一反	commentary
其逋	補吴反	commentary
之虚	去魚反	source
王相	于況反下息亮反	commentary
講虚	本又作構各依字讀	_
此夫	音扶	commentary
先君之敗德及	絶句	commentary
可數乎	一讀及可數乎數音色主反	source
雖復	扶又反下同	commentary
之孽	魚列反	commentary
僔	尊本反	commentary
沓	徒合反	commentary
有邪	似嗟反	source
以風	方鳳反	_
知達	音智	source
不憚	徒旦反	source
而舎	如字又音捨	commentary
言還	音環	source
饋七	其位反	commentary
蛾	魚綺反本或作蟻一音五何反	commentary
晳	本或作析又星歷反	commentary
盍行	戸臘反	commentary
焉入	於䖍反	commentary
又餼	許氣反	commentary