成下第十三杜氏盡十八年經十一年郤犫	尺由反	_
僑如	其驕反	source
傳十一年且涖	音利又音類	_
不娉	本亦作聘匹政反	_
叔肸	許乙反	source
無媒	亡回反	source
爲姒	音似	source
失儷	力計反耦也	source
沈其	徐直䕃反注同一音如字	commentary
已不能	音以又音紀	commentary
庇其	必利反又音祕	commentary
伉	苦浪反敵也	commentary
不復	扶又反下文注復岀皆同	commentary
惡惠	烏路反	source
伯與	音餘本亦作輿	source
于鄄	音絹	source
前好	呼報反注同	source
鄇田	音侯字林音候	source
候人	如字本又作鄇又音侯	_
單襄	音善	commentary
與檀	徒丹反	source
勞文	力報反	_
狐溱	側巾反	_
華元	戸化反	source
令狐	力丁反	commentary
史顆	苦果反	_
而背	音佩卷内皆同	commentary
經十二年璅澤	素果反依字冝作瑣	_
傳十二年之難	乃旦反	_
公子罷	音皮	_
好惡	並如字又上呼報反下烏路反	_
菑危	音災	_
交贄	本又作摯之二反	_
無壅	於勇反	_
有渝	羊朱反	_
殛	本亦作極紀力反誅也注同	_
卑	必爾反使也本亦作俾	source
隊	直類反失也注同	source
胙國	才故反	_
成好	呼報反盡年皆同	_
閒宋	閒厠之間	_
子反相	息亮反	source
而縣	音玄注同	source
云莫	音暮本亦作暮	source
施及	以豉反	commentary
重之	直用反	commentary
加遺	唯季反	commentary
焉用	於䖍反	commentary
之治	直吏反下注治世同	source
閒於	音閑注同	_
享宴	許丈反舊又許亮反本亦作饗宴音於見反徐於顯反	source
不倚	於綺反	commentary
則折	之設反	commentary
朝而	直遥反朝日朝徐音朝旦之朝	source
以扞	戸旦反蔽也	commentary
赳赳	居黝反一音居醜反	commentary
扞難	乃旦反	commentary
干城	戸旦反本亦作扞又如字	source
貪冒	莫報反又亡北反	commentary
爲搏	音博	commentary
噬之	市制反	source
以駁	邦角反	_
能爲	于僞反又如字	source
以語	魚據反	source
矣夫	音扶本亦無此字	commentary
必復	扶又反	commentary
鄢陵	謁晚反漢書音義一建反	commentary
經十三年郤錡	魚綺反	_
道過	古禾反又古臥反	commentary
伯廬	力吳反本亦作盧	_
傳十三年而惰	徒臥反	_
先使	所吏反	commentary
子從	才用反	commentary
爲介	音界	commentary
輔相	息亮反下同	commentary
受脤	市軫反冝社之肉也	commentary
盛以	音成	source
盡力	津忍反下同	commentary
執膰	音煩祭肉也	source
吕相	息亮反注同	source
逮我	音代一音大計反	commentary
相好	呼報反下同	commentary
勠力	相承音六嵇康力幽反吕靜字韻與飂同字林音遼	_
辟麗	上音避下力知反	_
卑我	必爾反本亦作俾下及注同	_
躬擐	音患	commentary
甲胄	直又反	commentary
跋履	蒲末反草行也	commentary
之疆	居良反	source
埸	音亦	source
不詢	思巡反謀也	source
擅及	市戰反	source
恐懼	丘勇反	source
蔑死我君	本或以我字在死上非	commentary
迭我	直結反徐音逸	commentary
殽地	戸交反	source
奸絶	音干	commentary
費	符味反	commentary
滑	于八反	commentary
緱氏	古侯反	source
撓亂	乃卯反徐許髙反	_
傾覆	孚服反下同	source
之隕	于敏反下同	source
事見	賢遍反	commentary
逞志	勑景反快也	source
欲闕	其月反徐如字	commentary
蝥賊	莫侯反爾雅蟲食苗爲蝥食節爲賊	commentary
不悛	七全反改也	source
涑川	徐息録反又音速字林同	commentary
俘我	芳夫反	source
不復	扶又反	commentary
惠稱	尺證反注同	source
狄難	乃旦反	source
箕	音基一音其	commentary
郜	古報反	source
芟	所銜反	source
痍	音夷本又作夷傷也	commentary
之聚	才喻反衆也注同	source
儌福	古堯反	_
與女	音汝下文皆同	source
同好	呼報反一音如字	source
復脩	音服又扶又反	commentary
我寡君	讀者亦作寡人	commentary
季隗	五罪反	commentary
廧	在良反	commentary
咎如	音羔	commentary
狄應	應對之應注同	source
惡君	烏路反下同	source
昊天	戸老反	source
康共	音恭	commentary
以懲	直升反	commentary
昵就	女乙反親也	_
要也	一遥反	source
欲道	音導	source
將中軍	子匠反凡將某軍者放此以意求之	source
趙旃	之然反	commentary
欒鍼	其廉反	source
晉帥	所類反注同	source
乗和	繩證反注同	commentary
麻隧	音遂	source
成差	初佳反徐初冝反	source
不更	音庚	source
女父	音汝	source
復不	扶又反	source
侯麗	力馳反	source
徑扶風	音經	source
迓	本又作訝五嫁反迎也	commentary
子般	音班林作班	_
自訾	子斯反	commentary
大宫	音泰下同	source
子印	一刃反	commentary
子駹	武邦反	source
負芻	初俱反	source
守	手又反	commentary
欣時	如字徐云或作款亦音欣案公羊傳作喜時冝音忻	source
經十四年傳十四年侯彊	其丈反注同	_
見	賢遍反注強見下而見之同	source
又以爲	如字或于僞反	commentary
雖惡	烏路反	source
而宥	音又	source
子相	息浪反注同	source
叔傲	五報反本又作敖音同下同	commentary
享食	音嗣	source
兕	徐辭姊反	source
觥	古橫反	_
其觩	徐音虯又巨彪反一音巨秋反	source
好禮	呼報反	commentary
所敗	必邁反下同	source
復伐	扶又反	commentary
疆許	居良反下同	source
舎族	音捨注同	commentary
之稱	尺證反	source
而晦	呼内反	commentary
婉而	怨晩反	commentary
不汙	憂于反曲也注同	source
懲惡	直升反	commentary
子衎	涂苦旦反	source
不内	如字徐音納	source
酌飲	市畧反又章畧反	commentary
國也夫	音扶	commentary
鱄也	徐市戀反一音專	commentary
不聳	息勇反	commentary
舎其	音赦或音捨	source
盡寘	之豉反	commentary
經十一年世子成	音城	_
共公	音恭	source
欲挾	音協	commentary
士夑	息協反	_
無咎	其九反	source
子鰌	音秋	commentary
同好	呼報反	commentary
于葉	舒渉反	commentary
傳十五年將見	賢遍反	_
應天	應對之應	source
不拘	九于反	source
子囊	乃郎反	source
以庇	必利反又音祕	source
暴隧	音遂	commentary
數戰	所角反	commentary
少司宼	詩照反下同	_
鱗矔	古亂反	source
向蔕	音帶本又作帶	_
大窣	音㤗	_
戌在	音恤	_
故去	起吕反	source
於睢	音雖徐許惟反又音綏	commentary
得復	扶又反	commentary
登丘而望之則馳	絶句	commentary
騁而	勑景反	commentary
睢澨	市制反水涯也	source
水涯	本又作崖魚佳反一音冝	commentary
決壞	音怪	commentary
登陴	毗支反	commentary
樂裔	以制反	commentary
州犂	力兮反	source
而驟	仕救反	source
民惡	烏路反	source
子好	呼報反	commentary
於難	乃旦反	source
傳見	賢遍反	commentary
經十六年雨木冰	如字公羊傳云雨而木冰也舊于付反	_
著樹	直畧反	commentary
欒黶	於斬反徐於玷反	source
鄢陵	謁晚反又於建反	source
苕丘	音條	commentary
非使	所吏反	source
㓨公子	七賜反爾雅云殺也依字作刺	_
傳十六年近鄭	附近之近	_
將鉏	仕魚反徐在魚反	source
諸汋	七藥反徐音酌一音市藥反	source
陂	彼冝反	source
夫渠	音扶	commentary
不儆	京領反	source
覆之	徐敷目反一音扶又反又芳又反	source
汋陵	音勺又七藥反一音常藥反	commentary
爲晉	于僞反	source
居守	手又反	source
句耳	古侯反	commentary
與往	音預注同	source
非使	所吏反	source
過申	古禾反	source
正邪	似嗟反注皆同	commentary
下應	應對之應	source
烝民	之承反注同	source
敦厖	莫邦反敦厚也厖大也	source
其好	呼報反	commentary
瀆齊	徒木反	source
話言	戸快反	source
奸時	音干本或作千	source
而罷	音皮本亦作疲下注同	_
所底	徐音旨一音之履反	source
吾不復見子矣	扶又反一本無復字	source
喪列	息浪反下同	commentary
以紓	音舒緩也	source
以遺	唯季反下注問遺也同	source
集睦	集又作輯音同亦七入反	_
復從	徐子容反音或如字	commentary
之亟	去吏反數也	source
亟數	所角反	source
驕亢	苦浪反	source
盍釋	戸臘反	commentary
晨壓	於甲反徐於輒反	commentary
而陳	直覲反下及注皆同	source
笮其	側直反	commentary
范匄	本又作丏古害反	commentary
行首	戸郎反一音如字注同	commentary
營壘	力軌反	commentary
輕窕	勑彫反又勑弔反	source
相惡	如字又烏路反	source
王卒	子忽反下皆同	commentary
而嚻	許驕反徐讀曰嗷五髙反注及後同	source
諠	況元反本又作喧	commentary
譁	音華本又作嘩	commentary
巢車	說文作轈云兵車髙如巢以望敵也字林同	source
爲櫓	音魯	commentary
大宰	音泰官名大者多同以意求之	source
張幕	音莫	source
塵上	時掌反	source
爲行	戸郎反下夾公行同	source
皆乗	繩證反下同	commentary
左將	子匠反下去將同	source
帥	所類反下元帥同	commentary
戰禱	丁老反或丁報反	source
賁皇	扶云反	commentary
故憚	徒旦反	source
萃於	似醉反	source
國䠞	子六反	commentary
射其	食亦反注及下射之同	source
中厥	丁仲反注同	commentary
陽長	丁丈反	source
激南	古狄反	source
有淖	乃孝反徐徒較反泥也	commentary
共王	音恭	source
夾公	古洽反	commentary
焉得	於䖍反	source
冒也	莫報反徐莫北反	commentary
離局	力智反注同	commentary
逺其	于萬反	source
掀公	徐許言反云捧轂舉之則公軒起也一曰掀引也胡根反一音虚斤反字林云舉出也火氣也又丘近反	source
潘尪	烏黃反	_
之黨	一本作潘尪之子黨案注云黨潘尪之子也則傳文不得有子字古本此及襄二十三年申鮮虞之傅摯皆無子字	source
蹲甲	在尊反徐又在損反聚也一音才官反	commentary
七札	側八反徐又側乙反	commentary
夸王	苦瓜反	source
尚知	音智	source
詰朝	如字注同	commentary
言女	音汝	source
夢射	食亦反下至使射吕錡皆同	commentary
中之	丁仲反下及注皆同	source
中項	戸講反	source
伏弢	他刀反弓衣也	source
韎韋	莫拜反又音妳徐莫蓋反	source
之跗	方于反	source
注	之樹反	source
若袴	苦故反	source
而屬	章玉反	source
猶近	如字一本作與音預	commentary
介者	音界	source
爲事	于僞反	source
使者	所吏反注及下同	source
今撎	伊志反揖也字林云舉首下手也	commentary
杜溷	戸昬反又戸本反	source
茀	府勿反	commentary
翰胡	徐音韓	source
諜	音牒	commentary
輅之	五嫁反	source
之乗	繩證反	commentary
輕兵	遣政反又如字	commentary
不去	起吕反	source
於熒	戸扃反	source
内旌	音精	source
叔山冉	如琰反	source
爲國故	于僞反	source
乃射	食亦反	source
再發	如字徐音廢	source
盡殪	於計反	source
搏人	音博	source
中軍	丁仲反	commentary
折	之設反又市列反	commentary
軾	音式	commentary
子茷	扶廢反	commentary
謂夫	音扶	_
之麾	許危反	commentary
日臣	人實反	commentary
之使	所吏反下免使者同	commentary
好以	呼報反下及注皆同	commentary
閒暇	音閑	_
不使	所吏反又如字	source
往飲	於鴆反	source
執榼	苦臘反	source
造于	七報反	source
得犒	苦報反	source
從者	才用反	source
而復	扶又反注及下同	commentary
卒乗	繩證反下同	commentary
展陳	如字	source
徇曰	似俊反	commentary
蒐乗	所留反	source
秣馬	音末	source
脩陳	直覲反又如字	commentary
蓐食	音辱	source
申重	直用反	commentary
逸縱	子用反	commentary
能見	賢遍反	source
天敗楚也夫	音扶	source
三日榖	本或作三日館榖誤也	commentary
君幼	本或作君幼弱	commentary
之覆	芳服反	commentary
臣之卒	從此巳前皆子忽反	commentary
初隕	于敏反	source
盍圖	戸臘反	commentary
壞隤	戸怪反徐音懷下徒回反	commentary
欲去	起吕反	commentary
晉難	乃且反	commentary
子鉏	仕居反	commentary
女不可	音汝	source
儆備	京領反	source
設守	手又反	commentary
未弭	亡氏反	source
有篡	初患反	commentary
殺	音試	commentary
不復	扶又反下及下文復請同	commentary
以伯	如字又音霸	commentary
申守	手又反下注同	commentary
敢過	古臥反又古禾反	source
食使者	音嗣使音所吏反注同	source
之介	音界下文敢介大國同	source
而後食	一本作聲伯而後食	source
不與	音預	source
將主	子匠反	source
我斃	婢世反	source
廩丘	力甚反	_
茍去	起吕反下同	_
淫慝	吐得反下文同	commentary
則夫	音扶	commentary
若朝	如字	commentary
吾爲	于僞反	source
相二	息亮反	commentary
不衣	於旣反	source
不食	舊如字對上句應作嗣音	commentary
偃與	音預	commentary
其難	乃旦反	commentary
始見	賢遍反	source
亦閒	徐音閒厠之閒讀者或如字	_
語諸	魚據反	source
不見	賢遍反又如字注同	source
經十七年北宫括	古活反	_
柯陵	古河反	source
貍	力之反	source
脤	市軫反	commentary
貜	俱縛反徐居碧反	commentary
且	子餘反	commentary
傳十七年虛滑	起居反	_
髠頑	苦門反	commentary
侯獳	乃侯反	commentary
爲質	音致	commentary
戲童	許冝反	source
曲洧	于軌反	source
治曲	直吏反	commentary
驕侈	尺氏反又尸氏反	commentary
難將	乃旦反下同	source
祝我	之又反	source
與婦人	如字徐音預	source
于閎	音宏巷門也	source
相冒	亡報反	commentary
讁我	直革反責也	_
譴責	遣戰反	source
相靈	息亮反下相施氏同	commentary
處守	手又反	source
而索	所白反注同	source
頃公	音傾	commentary
刖鮑	音月又五刮反	source
匡句須	其俱反	_
之知	音智	commentary
嚮日	許亮反本亦作向	_
危行	下孟反	commentary
渉洹	音桓一音恒今土俗音袁	source
林慮	力於反	source
長樂	音洛下樂平縣同	commentary
瓊	求營反玉也	source
瑰	古回反珠也	commentary
含象	戸暗反本亦作唅	commentary
言之之莫	音暮	source
戒數	所角反	source
崔杼	直吕反	source
以難	乃旦反下及注同	commentary
盧降	下江反	source
反自鄢	一本又作自鄢陵	commentary
盡去	起吕反下文同	source
而嬖	必計反	commentary
魚矯	居表反	commentary
而梏	古毒反	commentary
械也	戸戒反	commentary
軍帥	所類反	commentary
居守	手又反	source
敵使	所吏反	source
君盍	戸臘反	commentary
嘗使	所吏反又如字	_
覘之	勑廉反	commentary
伺也	音司又絲嗣反	commentary
射而	食亦反	commentary
不偪	彼力反下同	source
易有	以䜴反	source
信知	音智下同	commentary
清沸	甫味反	commentary
魋	徒回反	source
結衽	而甚反徐而鴆反	_
坐處	昌慮反	commentary
一朝	如字	commentary
為軌	本又作宄音同	_
御姦	魚呂反下同	commentary
不施	如字或式豉反	source
違去	起呂反下同	source
厥少	詩照反	commentary
焉用	於䖍反	source
道呉	音導下及注同	commentary
伐駕	如字一音加	commentary
釐	力之反	commentary
虺	許鬼反	commentary
橐師	他洛反	source
經十八年復入	扶又反	_
鹿囿	音又	commentary
遣輕	遣政反	source
士魴	音房	commentary
于虛	起居反	_
朾	他丁反	commentary
傳十八年一乗	繩證反注同	_
其少	詩照反	source
菽麥	音叔	commentary
易別	以豉反下彼列反	_
癡者	勑疑反	source
齊為	于偽反	_
之難	乃旦反	commentary
王湫	子小反徐子鳥反	commentary
奔萊	音來	commentary
殺絶	音試	source
施舎	如字一音始豉反	commentary
止逋	布呉反	source
逮鰥	古頑反	commentary
淫慝	他得反	source
賦斂	力驗反	source
宥	音又	source
罪戾	力制反	source
節省	所景反下同	source
不從	子用反本亦作縱	commentary
魏相	息亮反	source
魏頡	戸結反	commentary
魏顆	苦果反	source
孝弟	音悌本或作悌	source
渥濁	於角反	source
右行	戸郎反	source
士蔿	于委反	source
辛將	子匠反下軍將同	source
弁	皮彦反本又作下同	source
糾	居􁇠反	source
校正	戸孝反注同	commentary
共時	音恭本亦作供下文同	source
省卿	所景反	source
令軍	力呈反	source
鐸	待洛反	source
遏	於葛反徐音謁	commentary
訓卒	子忽反	source
乗	繩證反下及注皆同	source
六騶	側留反	commentary
之長	丁文反	commentary
軍帥	所類反下之帥爲帥皆同	commentary
以復	扶又反下及注復入皆同	source
以上	時掌反	source
取朝	如字	source
郟	古洽反	source
城郜	古報反	source
三百乗	繩證反	commentary
惡其	烏路反	source
曰復歸	音服一音扶又反	commentary
以惡曰復入	本或作以惡入曰復入	commentary
西鉏	仕居反徐在居反	commentary
吾	音魚西鉏吾人名也	commentary
無猒	於鹽反	_
猶憾	戸暗反	commentary
以閒	如字又閒厠之閒	_
吾釁	許靳反	source
而披	普彼反注同分也	commentary
崇長	丁文反	source
患難	乃旦反	commentary
勞公	力報反	source
語之	魚據反注同	source
來見	賢遍反	source
台谷	勑才反一音臺	commentary
彘季	直例反	source
世適	丁歴反	_