襄元	襄公名午成公子母定姒諡法因事有功曰襄辟土有德曰襄	source
第十四杜氏盡九年經元年魯與	音預	_
于鄫	才陵反	source
公孫剽	匹妙反字林匹召反	source
傳元年爲宋	于僞反	_
彭城降	戸江反注同	commentary
歸寘	之豉反	commentary
瓠丘	徐侯吳反音戸故反	commentary
東垣	音袁	commentary
爲質	音致	source
其郛	芳夫反	source
元帥	所類反	commentary
於洧	于軌反	commentary
焦夷	如字徐在堯反	commentary
不與	音預	commentary
鄼縣	才河反又子旦反	source
迂迴	音于	source
繼好	呼報反	source
經二年伯睔	古囷反徐又胡忖反	_
甯殖	市力反	_
齊姜	如字諡法執心克莊曰齊或音側皆反非	source
傳二年伐萊	音來	_
正輿子	音餘本亦作與	commentary
以索	所白反	commentary
諡應	應對之應年末同	_
其行	下孟反	source
美價	古雅反木名	_
爲櫬	初覲反棺也	source
養姑	徐余亮反	source
話言	戸快反善也	commentary
哲知	音致下同	commentary
爲不哲矣	一本作不爲哲矣	commentary
之妣	必履反	source
公適	丁歷反本亦作嫡	commentary
丞	之承反	_
卑	必利反與也注同	commentary
以洽	戸夾反	source
孔偕	音皆	commentary
偕徧	音遍	source
越疆	居良反	commentary
齊竟	音境	source
負擔	都暫反	commentary
射楚	食亦反	source
非異人任	音壬注同絶句一讀至人字絶句	source
不爲	于僞反	commentary
若背	音佩	commentary
棄力	服本作棄功	commentary
誰暱	本又作昵女乙反徐乃吉反	commentary
復憂	扶又反下文將復復會同	source
經三年長樗	勑居反	_
單子	音善	commentary
袁僑	其驕反	commentary
傳三年鄧廖	力彫反	_
組甲	音祖下皆同	commentary
被練	皮義反徐扶僞反注及下同	commentary
要而	於遥反	source
咎子	其九反	commentary
憂恚	一僞反	commentary
子相	息亮反皆同	source
介在	音界	commentary
晉爭	爭鬪之爭	commentary
爲鄭	于僞反	commentary
吳好	呼報反	_
不易	以豉反注同	source
多難	乃旦反年内同	commentary
虞度	待洛反	source
于耏	音而	_
解狐	音蟹	source
爲諂	他檢反	_
爲比	毗志反	source
能舉善也夫	音扶絶句一讀以夫爲下句首	source
頃公	音傾	commentary
亂行	戸郎反注同	source
行陳	直覲反	source
用鉞	音越	source
公跣	先典反	source
無重	直用反注同	source
禮食	音嗣注同又如字	commentary
特爲	于僞反	commentary
經四年傳四年爲陳	于僞反	_
鮦陽	孟康音紂直九反一音童或音直勇反非	commentary
有咎	其九反下同	commentary
肆夏	戸雅反注及下同	commentary
奏九夏	一曰王夏二曰肆夏三曰韶夏四曰納夏五曰章夏六曰齊夏七曰族夏八曰陔夏九曰驁夏	commentary
肆夏一名樊	國語云金奏肆夏樊遏渠杜遂分爲三夏之別名吕叔玉云肆夏時邁也樊遏執競也渠思文也	commentary
韶夏	上招反	commentary
名遏	於葛反	commentary
夏納	本或爲納夏誤	commentary
名渠	其居反	source
子貟	音云徐于貧反	source
通使	所吏反下注及文皆同	commentary
藉之	在夜反薦也	commentary
舎其	音捨	commentary
而重	直用反下皆同	source
敢與	音預下及與同	source
牧伯	徐音目	source
相樂	音洛	commentary
以勞	力報反注以此勞同	source
騑騑	芳非反	commentary
咨諏	子須反	_
咨度	待洛反下文注同	_
咨詢	音荀	_
咨難	乃旦反	source
不過	古禾反	source
君長	丁丈反注同	source
爲已	于僞反下注爲定姒爲言下爲執事同	commentary
蒲圃	布古反	source
場	直良反	source
不御	魚吕反止也注同	source
須句	其俱反	commentary
顓	音專	source
㬰	羊朱反	_
之比	必二反	commentary
蓋相	息亮反	commentary
朝夕	如字	commentary
褊小	必淺反	source
不共	音恭	source
願借	子亦反注同	source
閒陳	閒厠之閒	_
伺	音司	commentary
閒	音閑又閒厠之閒又如字	_
其使	所吏反	source
夏訓	戸雅反下注皆同	commentary
后羿	音詣	source
自鉏	仕居反	source
大康	音泰	source
中康	音仲下同	_
子相	息亮反下及注同	commentary
熊髠	苦門反	source
尨	莫邦反	commentary
圉	魚吕反	source
寒浞	仕角反徐在角反	source
樂之	音洛下樂安同	source
詐慝	他得反後同	source
不悛	七全反改也	commentary
而亨	普彭反煮也	source
以食	音嗣注同	commentary
有鬲	音革	source
生澆	五弔反	source
及豷	許器反	source
斟	之林反	commentary
灌	古亂反	source
于過	古禾反注及下同	commentary
干戈	古禾反	_
掖縣	音亦漢書作夜孟康音掖	source
之燼	才刃反遺民也	source
少康	詩照反注及下同	source
后杼	直吕反	commentary
官箴	之林反	source
芒芒	莫郎反逺貌	commentary
畫爲	乎麥反分也	commentary
攸家	如字本或作攸處	source
不擾	如小反亂也	source
冒于	莫報反貪也又亡北反	commentary
其麀	音憂鹿牝也	commentary
牡	茂后反	commentary
可重	直用反下文同	commentary
猶數	所角反	commentary
不恢	苦回反大也	source
以好	呼報反下文同	commentary
不懲	直升反	commentary
荐居	在薦反又才遜反聚也或云草也	commentary
易土	以豉反輕也徐神豉反注同	commentary
可賈	音古	source
不聳	息勇反懼也	commentary
公說	音恱	commentary
臧紇	恨發反	source
狐駘	徒來反徐勑才反	commentary
畨縣	本又作蕃應劭作皮一音方袁反白襃魯國記云陳子遊爲魯相畨子也國人爲諱改曰皮	source
目台	吐才反	source
皆髽	側瓜反	source
合髻	音計本又作結又作紒音同	_
朱儒	本或作侏亦音朱	source
經五年子巫	亡扶反	_
鄫見	賢遍反	commentary
不復	扶又反下同	source
傳五年愬戎	悉路反	_
淩虣	白報反	_
奉使	所吏反	commentary
覿鄫	直歷反見也	source
見也	賢遍反	commentary
之好	呼報反	source
將爲	于僞反	source
共王	音恭	commentary
嚴斷	丁亂反	source
挺挺	他頂反正直也	commentary
扃扃	工迥反徐孔穎反明察也	commentary
背盟	音佩	source
鄫近	附近之近下文陳近同	commentary
魯竟	音境	source
致譴	棄戰反	source
故復	扶又反	source
所以見	賢遍反	commentary
子囊	乃郎反	commentary
我喪	息浪反	source
改行	如字徐下孟反	source
民朝	如字	commentary
城棣	直計反一音徒妹反	commentary
入斂	力豔反	commentary
西郷	許亮反	source
宰庀	匹婢反具也	source
無衣	於旣反	commentary
無食	如字又音嗣	source
無重	如字又直龍反	commentary
相三	息亮反	commentary
私積	子賜反	source
經六年傳六年少相	詩照反	_
狎	戸甲反習也	commentary
長相	丁丈反	source
調戲	徒弔反	source
梏華	古毒反	source
以貫	古亂反	source
其懦	乃亂反又乃臥反	commentary
射子罕	食亦反注同	commentary
幾日	居豈反	source
射女	音汝	commentary
不勝	音升	source
見且	賢遍反注同	source
復託	扶又反	commentary
堙之	音因土山	source
環城	戶關反又音患	commentary
傅於	音附	source
堞	音牒女牆也一名俾亦謂之俾倪徐養涉反	source
王湫	子小反徐子鳥反	source
共公	音恭	source
遷于郳	五兮反本或作遷萊于郳萊衍字	commentary
其疆	居良反	source
經七年郯子	音談	_
城費	音祕	source
事難	乃旦反	commentary
于鄬	于軌反字林几吹反	source
于鄵	七報反又禾南反字林千消反	source
所殺	音試下同	_
為書	于偽反	_
上其名	時掌反	source
傳七年啟蟄	直立反	_
夏正	戸雅反	source
隧正	音遂	commentary
多難	乃旦反	commentary
長子	丁丈反下師長同	commentary
好仁	呼報反注及下同	source
靖共	音恭下注同	source
介爾	音界下及注同	source
參和	七南反或音三	commentary
臣後	胡豆反下文不後寡君同	source
子相	息亮反下子駟相同	commentary
未嘗後	如字徐胡豆反	_
無悛	七全反	source
委蛇	於危反下以支反下同	commentary
召南	上照反	source
為執	于僞反	_
背君	音佩	commentary
經八年公子燮	悉協反	_
邢丘	徐音刑	source
悼難	乃旦反	commentary
傳八年復脩	扶又反	_
伯業	音霸又如字本亦作霸	_
先之	悉薦反又如字	commentary
辟殺	婢亦反罪也注同	_
子熙	許其反徐音怡	_
以疆	居良反注同	commentary
子蟜	居表反	source
人壽	音授或如字注同	commentary
幾何	居豈反	source
之難	乃旦反	commentary
以紓	音舒	commentary
敬共	音恭	source
二竟	音境注同	source
而庇	必利反又音秘下同	commentary
不罷	音皮	commentary
背之	音佩至卷未皆同	source
杖莫	直亮反下同	commentary
完守	手又反或如字下守官并注同	source
其咎	其九反下同	source
無適	丁歷反下同	commentary
騑也	芳非反	source
伯駢	扶賢反又扶經反	_
儆而	居領反	source
悉索	悉各反盡也注同一音所百反	source
女何	音汝	commentary
馮陵	皮冰反注同	source
啓跪	其委反	source
傾覆	芳服反	commentary
所控	苦貢反引也	source
夫人	音扶注同	source
一个	古賀反注同	commentary
獨使	所吏反	source
以見	賢遍反或如字	commentary
摽有	徐扶妙反又扶表反落也	source
以興	許譍反	source
今辟	音譬本多即作譬字後放此	_
彤弓	徒冬反	source
復受	扶又反	commentary
城濮	音卜	commentary
衡雍	於用反	source
孫臧	如字徐才浪反	_
經九年于戲	許冝反	_
傳九年畚	音本草器也	_
挶	九録反土轝也	commentary
具綆	古杏反汲水索	source
缶	方九反汲水瓦器	commentary
蕢	其位反	_
籠	力東反	source
土輿	音預	_
汲	音急	source
索	悉各反	source
盆􁐤	戸暫反	commentary
所任	音壬	source
畜	勑六反本又作蓄	commentary
水潦	音老	commentary
繕守	手又反注守備同	source
巡行	下孟反下同	source
丈度	待洛反下同	_
之處	昌慮反	commentary
摽表	必遥反	source
隧正	音遂	commentary
華閱	音恱	commentary
官庀	芳婢反具也下同	commentary
樂遄	市專反	commentary
皇鄖	音云本亦作貟音同	source
校正	戸敎反注同	commentary
出馬	如字徐尺遂反下同	source
武守	手又反下同	commentary
西鉏吾	音魚	source
儆宫	音景	commentary
四庸	本又作墉音同城也	_
般庚	歩干反字亦作盤	_
以禳	如羊反	commentary
渥濁	於角反	source
於咮	竹又反徐下遘反	commentary
以出	如字徐尺遂反	source
内	如字徐音納	source
鶉火	音純	source
得見	如字又賢遍反	commentary
閼伯	於葛反	commentary
相土	息亮反注同	commentary
契孫	息列反	source
之釁	許靳反	commentary
猶數	所主反下同	commentary
所更	音庚	source
遇艮	古恨反	commentary
曰亡	如字猶無也讀者或音無	commentary
元亨	許庚反下同	source
論彖	吐亂反	source
以折	之設反	commentary
之長	丁丈反下同	source
嘉德	易作嘉會	source
而與	音預	commentary
而姣	戸交反注同徐又如字服氏同嵇叔夜音效	commentary
士雃	苫田反	commentary
失選	息戀反注同	commentary
少於	詩照反下同	source
中行	戸郎反	commentary
欒黶	於斬反	commentary
新軍將	子匠反	source
晉饑	音飢又音機	commentary
鄟門	音專本亦作專	source
行栗	如字行道也栗表道樹	source
于氾	音凡	_
盛	音成	commentary
餱糧	音侯乾食也	commentary
肆眚	生領反徐所幸反	commentary
人恐	丘勇反	source
鄭復	扶又反	source
敝罷	音皮	commentary
暴骨	蒲卜反注同徐扶沃反	commentary
以爭	爭鬪之爭注同又如字	commentary
未艾	魚廢反息也一音五蓋反注同	commentary
公孫蠆	勑邁反	commentary
皆從	才用反	commentary
適子	丁歷反	commentary
使介	音界注同	commentary
介猶閒也	音閒厠之閒又如字	_
以要之	一遥反注強要下要人要盟皆同	source
強要	其丈反	commentary
歆其	許今反	source
墊	丁念反	commentary
隘	於懈反	source
所厎	音旨至也	commentary
以庇	必利反	source
能休	許虯反	commentary
復伐	扶又反下注同	source
閏月	依注讀爲門五日	commentary
隂阪	音反又扶板反	source
三畨	芳元反	_
更攻	音庚	source
洧津	于軌反	_
冠而	古亂反注下皆同	source
盍爲	戸臘反	commentary
以祼	古亂反	source
謂灌	古亂反	source
鬯酒	勑亮反	source
之祧	他彫反	source
罷戎	音皮徐音彼	commentary
中分	並如字徐音丁仲反	commentary
輸積	子賜反下同	commentary
聚	才住反	commentary
以貸	他代反	commentary
崇省	所景反	commentary
期年	音基本亦作朞	commentary
于向	舒亮反	_