昭四第二十三杜氏盡十七年經十三年圍費	音祕	_
乾谿	苦兮反	source
長垣	音袁	source
不與	音預注同	commentary
讒慝	他得反	commentary
侯廬	音盧又力居反	commentary
傳十三年囚俘	芳夫反	_
冶區夫	上音也區音烏侯反一音丘于反	source
衣之	於旣反	source
食之	音嗣	source
而共	音恭	commentary
若憚	待旦反	source
爲之聚也	于僞反	commentary
將焉	於䖍反	commentary
其效	戸孝反	source
薳	于委反	commentary
掩	於檢反	source
而質	音致	source
蔡洧	于軌反	commentary
使與	音預	source
於守	手又反	commentary
中犫	尺州反	source
郊竟	音境	commentary
蔓成然	音萬	source
羣喪	息浪反	commentary
常壽過	古禾反	source
其子從	如字	commentary
朝吳	如字	_
子晳	星歷反	commentary
強與	其丈反	_
己徇	音紀下似浚反	source
能爲	于僞反	source
黒肱	古弘反	commentary
不羹	音郎	source
許葉	始渉反	commentary
築壘	力軌反	commentary
辟	音壁本亦作壁	source
請藩	方元反注同離也	commentary
離也	依字應作籬今作離假借也力知反	_
須務牟	亡侯反	commentary
史猈	皮佳反徐扶蟹反又扶移反又或扶瞻反本或作篺音同	commentary
罷敵	音皮徐甫綺反一音蒲買反	source
魚陂	彼冝反	source
後者劓	魚器反截鼻之刑	commentary
訾梁	子斯反注同	commentary
而潰	戸内反	commentary
知擠	子細反隊也說文云排也一音子禮反	source
溝壑	許各反	source
隊也	直類反	commentary
祗取	音支	source
王㳂	以全反順流也	source
夏	戸雅反漢水也	source
入鄢	徐於建反一音於晚反入本或作至	source
芋尹	于付反徐又音羽	source
再奸	音干	commentary
謂斷	丁管反	source
棘闈	音韋棘里名闈門也孔晁云棘楚邑闈巷門	commentary
王縊	一豉反	commentary
殉而	似俊反	source
觀從謂子干	本或作謂子干曰	commentary
夜駭	户楷反	commentary
相恐	丘勇反下同	commentary
而呼	好故反下同	source
周徧	音遍	commentary
不書殺	申志反	_
熊居	音雄	source
衣之	於旣反	source
子旗	音其	source
五帥	所類反謂蕩侯潘子司馬裻嚻尹午陵尹喜五人	_
見舟	賢遍反	commentary
淮汭	如銳反	commentary
羣賂	音路	source
宥罪	音又	source
爲君	于僞反	source
犫櫟	力狄反	source
自說	音恱	commentary
不復	扶又反下將復使同	source
毋勤	音無	_
王柩	其久反	commentary
詬天	本又作訽呼豆反徐許后反	source
而呼	火故反	source
余卑	必利反徐甫至反與也	source
無厭	於鹽反	source
共王	音恭	commentary
冢適	丁歷反下無適音同	source
乃徧	音遍	commentary
見於	賢遍反下注微見同	source
巴姬	必加反	source
密埋	亡皆反	commentary
大室	音泰	commentary
五人齊	側皆反本又作齋	source
而長	丁丈反注及下同	commentary
跨之	苦化反	source
肘加	中九反	source
皆逺	于萬反	source
皆厭	於甲反徐又於豔反	commentary
紐	女九反璧紐也	source
審識	申志反又如字	commentary
屬成然	音燭	source
市賈	音古	_
好惡	並如字又上呼報反下烏路反下皆放此	source
爲應	應對之應	_
無釁	許靳反	_
苛	音何本或作荷音同下同	_
慝	他得反	commentary
芈姓	彌爾反	_
以去	起吕反	_
數其	所主反	commentary
又逺	于萬反	_
其貴亡矣	亡音無又音如字	_
下善	遐嫁反	source
齊肅	側皆反注同嚴也	commentary
藏賄	呼罪反	source
不從	子用反	commentary
不厭	於豔反	source
好學	呼報反	commentary
趙衰	初危反	commentary
顚頡	戸結反	commentary
從出	才用反	commentary
賈佗	徒河反	source
齊妻	七計反	commentary
欒	魯官反	commentary
卻	去逆反	commentary
縠	戸木反	source
方相	息亮反下同	source
共有	音恭	commentary
奥主	烏報反	source
無施	式豉反	source
虒祁	音斯	source
爲取	于僞反	source
郠故	亡杏反	commentary
下邳	皮悲反	commentary
四千乗	繩證反下及注皆同	source
羊舌鮒	音附	source
幄幕	於角反下音莫四合象宫室曰幄在上曰幕軍旅之帳也	commentary
淫芻	初伹反說文云刈草也	source
蕘	如遥反飼牲曰芻草薪曰蕘	commentary
屠伯	音徒	source
饋叔	其位反	commentary
一篋	苦協反	source
瀆貨	徒木反	source
無厭	於鹽反	commentary
數也	音朔	source
爲此役也	如字或于僞反	commentary
以厎	音旨	commentary
傾覆	芳服反	source
閒朝	閒廁之閒	_
長幼	丁丈反	source
巡守	手又反	source
方嶽	音岳	source
於好	呼報反下注同好同	commentary
不治	直吏反舊如字	commentary
齊犧	許冝反	commentary
不旆	歩貝反	source
復旆之	扶又反	commentary
以恐	丘勇反下同	source
愬于	音素	_
朝夕	如字注同	source
幾亡	音祈	source
不共	音恭注及下注同	source
雖瘠	在亦反	source
僨於	方問反仆也	source
仆也	音付一音蒲北反	source
𣏌鄫	才陵反	source
近魯	附近之近	commentary
數以	音朔	source
敢與	音預下文不與同	source
造于	七報反	source
爲墠	音善本或作壇	_
會處	昌慮反	source
先盟	悉薦反	commentary
好以	呼報反	commentary
使人	所吏反	source
咎之	其九反	commentary
瀆易	以鼓反	commentary
競爭	争鬪之爭下争競同	commentary
䝉裹	音果	_
司鐸射	徒洛反下食亦反又食夜反	source
奉壺	芳勇反	_
以蒲	本又作匍同歩都反又音扶本亦作扶	commentary
伏	本又作匐同蒲北反又音服	source
守者	手又反又如字	commentary
御之	魚呂反	commentary
徃飲	於鴆反	_
箭筩	音童又音勇	source
子服湫	子小反徐音椒又子鳥反案子服湫又作子服椒止一人耳	source
從	才用反注同	source
為治	直吏反	_
不警	音景	source
舊好	呼報反	commentary
守備	手又反	source
若為	于偽反下為夷將為同	_
何瘳	勑留反	source
差也	初賣反	source
諺曰	音彥	commentary
將焉	於䖍反	commentary
卿稱	尺證反	source
坐叔	才臥反	commentary
使近	附近之近	commentary
經十四年去疾	起呂反	_
意恢	苦回反	commentary
惡之	烏路反	source
傳十四年以舍	音捨	_
司徒老祁	巨夷反字林上夷反	source
閒差	初賣反	_
遂刼	居業反	_
畏子以及今	絶句	commentary
能復	扶又反	commentary
子韓皙	星歷反	_
假好	呼報反	source
分貧	如字徐甫問反	source
長孤幼	丁丈反	_
收介特	音界又古賀反注同	source
單身	音丹	source
宥孤	音又	source
賦稅	始銳反	source
罪戾	力計反	commentary
詰姦	起吉反責問也	source
慝	他得反	source
屈罷	音皮	source
召陵	上照反	commentary
好於	呼報反注同	commentary
邊疆	居良反	commentary
著丘	直居反徐直據反	commentary
庚與	音餘本亦作輿	_
共公	音恭	source
惡公子	烏路反下同	source
公子鐸	符洛反	source
氏比	毗志反	source
無厭	於鹽反本又作饜下注同	source
居鄖	音云	source
公子鉏	仕居反	source
鄐	許六反又超六反	source
命斷	丁亂反注同	commentary
蔽罪	必世反斷也注同徐甫世反王補弟反	source
鬻獄	羊六反賣也	source
掠美	音亮取也	source
敗官	必邁反又如字	source
之稱	人證反	source
皐陶	音遥	_
乃施	如字服云施罪於邢侯也孔晁注國語云廢也口氏反	commentary
荅當	丁浪反	commentary
三數	色主反又色具反下同	source
不爲	于僞反	commentary
末減	武葛反末薄也減輕也	source
義也夫	舊音扶一讀方于反下同	commentary
爲頗	普河反	commentary
故重	直用反	commentary
經十五年籥入	羊略反	_
去樂	起吕反	source
爲叔弓	于僞反	source
復立	扶又反	source
不逺	于萬反	source
傳十五年將禘	大計反	_
齊戒	側皆反	source
有咎	其九反	source
之祲	子鴆反祅氣也	source
喪氛	芳云反徐扶云反惡氣也	commentary
蓋見	賢遍反	commentary
莅事	音利	_
故爲	于僞反	commentary
去樂	起吕反注及下同	commentary
費無極	扶味反	commentary
亦長	丁丈反	commentary
必及於難	乃旦反	source
故寘	之豉反	commentary
女何	音汝	commentary
而背	音佩	commentary
鼔聚	才喻反	_
好惡	呼報反下烏路反或並依字讀下並注皆同	source
不愆	起䖍反過也	commentary
復加	扶又反	commentary
以庇	必利反又音祕	commentary
所喪	息浪反	commentary
而繕	市戰反	commentary
守備	手又反	source
請降	户江反	source
民見	賢遍反	source
將焉	於䖍反	commentary
以賈	音古下同	commentary
䳒	本又作鳶恱全反	_
鞮	丁兮反	commentary
不與	音預	_
荀櫟	力狄反本又作躒	_
爲介	音界	source
樽以	本或作尊又作罇並同	commentary
分器	扶問反年内同	source
彞器	以之反常也	commentary
而逺	于萬反又如字	source
故數	音朔	commentary
大蒐	所求反	source
姞姓	其吉反又其乙反	commentary
闕鞏	九勇反	commentary
出鎧	開代反	commentary
處參	所金反注同	commentary
鏚	音戚	source
鉞	音越	commentary
秬	音巨	source
鬯	音暢	commentary
彤弓	徒冬反	source
虎賁	音奔	commentary
東夏	戸雅反	source
福祚之不登叔父	絶句	source
焉在	於䖍反下將焉用之同	source
孫伯黶	於斬反	commentary
女司典	音汝	source
數典	色主反	source
所樂	音洛下文注皆同	commentary
絶期	居其反下同	source
靜黙	亡北反本或作嘿同	_
經十六年誘	音酉	_
雩	音于	commentary
傳十六年無質	之實反信也或音致	_
旣而復	扶又反	source
蒲隧	音遂	source
下邳	普悲反	source
取慮	上音秋下力居反如淳取音陬訾之陬慮音邾婁之婁	source
如陂	彼皮反	commentary
郯人	音談	source
甲父	音甫	source
之亢	苦浪反	source
也夫	音扶	commentary
我肄	以制反勞也徐又以自反注同	commentary
恭恪	苦各反	_
禦之	魚吕反止也注及下同	source
適縣	音玄注同	source
幾爲	居豈反數也服音機近也	source
言數	音朔	source
陵侮	亡甫反	source
夫猶	音扶	commentary
不衷	丁仲反又音忠	commentary
衷當	丁浪反或如字	commentary
刑之頗	普河反	commentary
類	如字事類也一音力對反注同徐又力猥反	commentary
放紛	芳云反	commentary
放從	子用反	_
罷民	音皮	source
承命以使	所吏反下奉命以使同	source
百乗	繩證反	commentary
受脤	市軫反	commentary
數世	色主反	_
焉得	於䖍反下將焉用之同	commentary
僻	匹亦反	_
邪	似嗟反	commentary
共朴	普角反	source
之守	手又反	source
無幾	居豈反	source
可偷	他侯反	source
若屬	音燭	commentary
盍求	戸臘反	commentary
之難	乃旦反下同又如字	source
一共	音恭下而共無藝同	commentary
何厭	於鹽反	_
不復	扶又反下弗敢復并注同	commentary
賈罪	音古下我無強賈同	commentary
銳乎	恱歳反細小也	commentary
成賈	音嫁本或作價	commentary
請夫	音扶	source
重求	直用反	source
比耦	毗志反	commentary
更相	音庚	commentary
以艾	魚廢反	commentary
蓬	蒲東反	source
蒿	呼髙反	commentary
藜	力兮反	source
藋	徒弔反	commentary
我無強	其丈反下強奪同又其良反注放此	_
毋或	音無下同	_
匄奪	古害反舊又姑末反乞也	commentary
寶賄	呼罪反或作貨	_
勿與	音預	source
以好	呼報反下及注並同	commentary
背盟	音佩	commentary
以徼	古堯反	source
餞宣子	賤淺反字林子扇反	source
子齹	才何反字林才可士知二反說文作云齒差跌也在河干多二反	source
蔓草	音萬	source
邂	戸賣反	source
逅	戸豆反	source
􁅈子	如住反	_
別於	彼列反	_
彼己	音記	_
舎命	音赦又音捨	commentary
不渝	羊朱反	source
褰裳	起䖍反	commentary
渉溱	側巾反	source
不復	扶又反	source
令子	力呈反下同	source
愛樂	音洛又五孝反	source
蘀兮	他洛反	source
印段	一刃反	_
其唱	昌亮反本或作倡同	_
和女	戸臥反下同女音汝	commentary
貺起	音況	source
皆昵	女乙反親也	commentary
數世	色主反	_
私覲	其靳反	source
命起舎	音捨	commentary
夫玉	音扶	source
藉手	在夜反注同	commentary
語季	魚據反	source
奢傲	五報反	commentary
惡識	烏路反	source
尚少	詩照反	commentary
屠擊	音徒	source
豎柎	音附又方于反	_
蓺山	音藝	source
令繁	力呈反	commentary
經十七年陸渾	戸門反	_
孛	音佩一音勃	source
長岸	五旦反	commentary
傳十七年菁菁	子丁反	_
者莪	五河反	source
樂且	音洛	commentary
饌	仕眷反	source
禦之	魚吕反注同	commentary
正月	音政	source
慝未	他得反	commentary
於夏	戸雅反下文當夏四月注當夏家同	commentary
是宿	音秀	source
瞽奏	音古	source
嗇夫	音色	source
少皡	詩照反下胡老反	commentary
己姓	音紀又音祀	_
師長	丁丈反	source
縉雲	音進	source
共工	音恭	commentary
大皡	音泰下同	source
少皡摯	音至	_
燕也	於見反	commentary
鶬	音倉	commentary
鴳	本亦作鷃於諫反	source
鷩雉	必滅反	commentary
爲蜃	市軫反	source
鷦鳩	音焦本又作焦本或作䳡子遥反或子堯反	source
鴡鳩	本又作雎七徐反	commentary
􁀳而	音至本亦作摯下同	_
有別	彼列反	_
鴶	本亦作秸簡八反又音吉	commentary
鵴	本亦作鞠居六反	commentary
爽鳩	所丈反	source
鶻鵰	陟交反又陟留反又音彫	source
五種	章勇反下同	source
曰鷷	音存又音遵本或作蹲	source
鶅雉	側其反	commentary
曰翟	音狄又音濁	source
曰希	如字一音丁里反本又作鵗	_
曰翬	許韋反	source
度量	音亮	commentary
九扈	音戸	source
鳻	扶云反又如字	commentary
鶞	勑倫反	commentary
唶唶	側百反又子夜反又助額反	source
嘖嘖	音責又音蹟	commentary
顓頊	音專下許玉反	source
屠蒯	苦怪反	commentary
於雒	音洛	source
乃警	音景	source
獻俘	芳扶反	source
以應	應對之應	commentary
夏之	戸雅反下文同	source
星見	賢遍反	commentary
彗所以	似銳息遂二反	commentary
嚮伏	許亮反又作向	_
火出而見	賢遍反下反注皆同	source
其與	如字又音預	commentary
之虚	起居反下同	commentary
之分	扶問反	source
濮陽	音卜	source
之牡	茂后反	commentary
相搏	音博本又作薄音同	_
當復	扶又反	commentary
禆竈	婢支反	source
瓘	古亂反	source
斝	古雅反	source
玉瓉	才旦反	source
勺也	上若反	source
以禳	本亦作攘如羊反下同	source
陽匄	古害反	source
魴也	音房	commentary
易用	以豉反	commentary
乗舟	如字又繩證反下同	source
環而	如字又音患	source
塹之	七豔反	source
其隧	音遂	source
炭	吐旦反	source
闔廬	戸臘反下力居反	commentary
喪先王	息浪反	commentary
長鬣	力輒反	source
髭	子斯反	source
鬚	音須	source
我呼	呼路反又如字下同	source
皆迭	待結反又音弟更也	source
迭更	音庚	source