䷓觀	官喚反示也乾宫四世卦	_
盥	音管	source
而不薦	王又作同牋練反王肅本作而觀薦	commentary
顒	魚恭反	source
足復	扶又反	commentary
旣灌	官喚反	commentary
不忒	吐得反	source
神道設敎	一本作以神道設敎	commentary
省方	悉井反	commentary
童觀	馬云童猶獨也鄭云稚也	commentary
最逺	袁万反	commentary
朝美	直遥反	commentary
所鑒	古暫反下同	source
趣	促裕反	commentary
闚	苦規反本亦作窺	commentary
者狹	户夾反	commentary
象曰闚觀女貞	一本有利字	source
不比	毗志反	source
觀國之光	如字或音官喚反	commentary
最近	附近之近	source
居近	如字	commentary
德見	賢遍反	source
平易	以豉反	source
盡夫觀盛故觀至大觀在上	王肅音官	_
以觀天下	徐唯此一字作官音	_
觀盥而不薦觀之爲道而以觀感風行地上觀處於觀時君子處大觀之時處大觀之時大觀廣鑒	亦音官	_
居觀之時爲觀之主觀之盛也	從盡夫觀以下並官喚反餘不出者並音官	_
周	_	_
易	_	source
上	_	commentary
經	_	_
噬	_	_
嗑	_	_
傳	_	_
第	_	_
三	_	commentary