禮運第九	鄭云禮運者以其記五帝三王相變易及隂陽轉旋之道	source
卷之七與於	音預	_
蜡	仕嫁反索也祭名夏曰淸祀殷曰嘉平周曰蜡秦曰臘字林作䄍	source
索	所百反	commentary
於觀	古亂反注同闕也	source
喟然	去媿反又苦怪反說文云大息	commentary
之處	昌慮反下同處同	commentary
逮	音代及也一音代計反	commentary
俊選	宣面反下文皆同	commentary
爲其	于僞反下文爲己皆同	source
禪位	善面反	source
所長	丁丈反	commentary
矜寡	古頑反	source
無匱	其媿反	commentary
有分	扶問反注同	commentary
良奥	烏報反	source
惡其弃	上烏故反下同	commentary
不憚	大旦反	source
施無	始豉反	commentary
吝心	力刄反又力覲反	source
禦風	魚吕反	source
傳位	丈專反	commentary
俗狹	音洽	commentary
嗇	音色	commentary
勇知	音智	_
敦朴	普角反	commentary
之稠	直由反	commentary
成治	直吏反	commentary
在埶	音世本亦作勢	commentary
者去	羌吕反注同	commentary
爲殃	於良反	commentary
復問	扶又反下復問同	source
相鼠	息亮反注同	_
遄死	市專反疾貌	source
殽於	戸敎反法也徐戸交反	source
冠昬	古亂反	_
朝聘	直遥反	commentary
則易	以豉反	commentary
之極言	如字徐紀力反	source
聞與	音餘	commentary
有小正	音征本或作有夏小正	source
坤	苦門反	source
乾	其連反	source
其燔	音煩	commentary
捭豚	卜麥反注作擗又作擘皆同	source
汚尊	烏華反注同一音作烏	_
抔	歩侯反手掬	commentary
蕢	依注音􁏷苦對反又苦怪反土塊也	source
桴	音浮鼓槌	commentary
齊敬	側皆反	source
釜	本又作鬴音父	_
甑	即孕反	commentary
燒石	如字又舒照反	commentary
鑿地	在洛反	source
掬	九六反本亦作臼音蒲侯反	commentary
堛	普逼反	source
摶土	徒端反	_
築	徐音竹	source
屋而號	戸毛反	source
皐某	音羔	source
飯	扶晚反注同	commentary
腥	音星	source
而苴	子餘反苞也徐爭初反	commentary
遣奠	弃戰反	source
知氣	音智	commentary
北首	手又反注同	source
南郷	許亮反注同	commentary
營窟	苦忽反	commentary
居橧	本又作増又作曽同則登反	commentary
樔	本又作巢助交反	commentary
茹其	音汝	commentary
衣其	於旣反	commentary
鑄作	之樹反	commentary
合土	如字徐音閤	source
令	音零	commentary
甓	歩歷反	commentary
及甒	音武	commentary
大也	音泰甒大皆樽名	source
臺榭	音謝本亦作謝	_
牖戸	音酉	_
以炮	薄交反徐扶交反	_
裹燒	音果	_
以燔	音煩加於火上	_
亨	普伻反煑也下合亨同	commentary
鑊	户郭反	_
以炙	之石反	_
貫之	古亂反	_
醴	音禮	source
酪	音洛	_
烝	之承反	_
釀	女亮反	_
酢	七故反	_
酨	才再反徐祖兾反	_
醴醆	側眼反	commentary
粢	依注爲齊才細反注五齊皆同	_
醍	音體	_
祝嘏	本或作假古雅反	source
之祜	音戸福也	_
粢讀	音咨	_
泛齊	芳劒反徐音汎	_
盎齊	烏浪反	_
爲主人	于僞反下同	_
其祝	之六反徐之又反注同	_
其殽	本或作肴戸交反	_
越席	音活注同字書作趏越席翦蒲席也杜元凱云結草	_
以幂	本又作鼏同莫歷反	_
衣其	於旣反	_
澣帛	戸管反	_
示號	音祇本又作祇	_
齍號	音咨皇云黍稷	_
大古	音泰下大史同	_
爓	似廉反	_
染	如豔反又如琰反	_
樂也	音洛	_
鈃	本又作鉶音刑盛和羹器形如小鼎	_
羮	音庚舊音衡	_
分別	彼列反下文同	_
於	音烏	commentary
乎	好奴反	source
吾舎	音捨下舎禮皆同	commentary
郊禘	大計反	commentary
鼷鼠	音兮	_
契	息列反	source
醆斝	古雅反又音嫁爵名也夏曰醆殷曰斝周曰爵	commentary
僭君	子念反注同	_
脅君	許劫反	commentary
儗於	音擬	commentary
焉	於䖍反	source
期不	居其反	commentary
入朝	直遥反注同	source
或與僕相	息亮反一讀如字則連下爲句	commentary
等輩	卜内反	_
弟鍼	其廉反又祇廉反	commentary
千乗	時證反	commentary
壞法	音怪	source
諱惡	烏路反	_
自拱	徐居勇反後拱持同	commentary
爲謔	許約反	source
孔甯	本又作寧案左傳作寧公羊作甯各依字讀	_
行父	音甫	source
數如	色角反	source
取殺	申志反或如字	_
大柄	兵命反	commentary
儐鬼	必刄反	source
以治政	皇如字徐直吏反下文注以治政同	commentary
爲言	于僞反下又爲遂爲皆同	commentary
所操	七刀反	commentary
臣倍	歩内反	commentary
俗敝	音弊本亦作弊	commentary
疵國	才斯反病也	commentary
肅峻	恤俊反	_
煇光	音暉	_
不見	賢遍反	commentary
殽以	戸教反注及下同	source
土㑹	古外反	source
而上	時掌反下上配上生皆同	commentary
共國	音恭	commentary
所樂	音岳又音洛又五孝反好也注同	source
治也	直吏反注同下以自治注身治成治皆放此	commentary
並倂	歩頂反	_
過差	初佳反一音初買反	commentary
何以守位曰仁	本亦作人	commentary
所養	羊尚反又如字下同	commentary
百姓則君	則音明岀注	commentary
分定	扶問反後文注除三分去一三分益一皆同	commentary
舎義	音捨	source
之知	音智注同	source
去其	羌吕反後皆同	source
之斷	丁亂反	_
之施	始豉反下施生同	commentary
謂之變	音辯岀注	commentary
耐以	音能	commentary
辟於	婢亦反開也徐芳益反	commentary
傳書	丈專反	source
愛惡	烏路反下皆同	source
弟弟	上如字下音悌	commentary
長惠	丁丈反	source
爭奪	爭鬪之爭	commentary
測度	大洛反	commentary
不見	賢遍反	commentary
竅於	徐苦弔反孔也	commentary
播於	彼左反舒也	_
五行四時	絶句本亦作播五行於四時	commentary
屈伸	音申	source
迭相	大計反又田結反	commentary
竭也	義作揭其列反負擔也	source
還相	音旋下同	commentary
六和	戸臥反注同	commentary
更相	古衡反下同	commentary
角徴	張里反	commentary
南事	律名京房律始於執始終於南事凡六十	commentary
畫繢	戸對反	commentary
以圜	音環又音圎	source
別聲	彼列反	_
被色	皮義反徐扶義反	_
爲柄	本又作枋兵命反	source
爲量	音亮下同	commentary
爲畜	許又反下同	source
政治	直吏反	commentary
於麟	良人反	commentary
相近	附近之近	source
操	七刀反	source
所捊	蒲侯反徐音普溝反	commentary
介僎	上音界下音遵	commentary
可睹	丁古反	commentary
爲倪	五計反視也	commentary
魚鮪	于軌反魚名	commentary
淰	音審徐舒冉反	commentary
矞	字又作獝況必反	commentary
狘	況越反	commentary
閃	失冉反	commentary
秉蓍	音尸	commentary
瘞	於例反一音於器反	commentary
繒	本又作増同似仍反又則登反又似登反	commentary
儐鬼	皇音賔敬也舊必信反	commentary
在朝	直遥反下同	commentary
卜筮	市制反	commentary
瞽	音古	commentary
侑	音又	commentary
皆應	應對之應	commentary
列宿	音秀	commentary
之藏	如字徐才浪反	commentary
大一	音泰下注同	commentary
合於月之分	本或作日月之分日衍字	source
曰養	音義出注	commentary
冠昬	古亂反	_
摯幣	本又作贄音至	commentary
罷也	音皮	_
大竇	音豆孔穴也	commentary
壞國	音怪又乎怪反	commentary
喪家	息浪反	_
有糵	魚列反	commentary
醇耳	市春反	commentary
養菁	子丁反	commentary
耨之	奴豆反鉏也	commentary
所盛	市正反又音成	commentary
乖刺	力達反本或作制	source
無耜	音似	commentary
不種	之用反不亦作弗何休注公羊云弗者不之深也下皆放此	_
不穫	戸郭反	_
知收	如字又手又反	_
不見	賢遍反	commentary
不苑	于粉反積也	source
不繆	音謬	commentary
有畜	丑六反	_
不殺	所戒反徐所例反注同	_
渚者	之汝反	_
漁人	音魚	_
獻鼈	必列反	_
蜃	石忍反	_
司爟	古亂反	_
卝人	華猛反又瓜猛反徐古猛反	_
仲夏	戸嫁反下同	_
謂食	音嗣	_
齊	才細反下皆同	source
頒爵	音班	_
必當	丁浪反	_
媒氏	音梅	_
而取	音娶本又作娶	_
稽士	古兮反	_
之烖	音災	_
妖孽	又作蠥魚列反妖又作祅說文云衣服歌謡草木之怪謂之祅禽獸蟲蝗之怪謂之蠥	_
螟	亡丁反	_
螽	徐音終	_
澧	本又作醴音禮	source
麒麟	音其下音票人反	commentary
郊棷	素口反徐揔㑹反澤也本或作藪	source
宫沼	之紹反池名	commentary
卵	力管反	commentary
胎	土才反	commentary
可俯	音府	commentary
而窺	本又作闚去規反	_
銀甕	本亦作罋烏弄反徐於弄反	_