漁父第三十一	以人名篇	source
緇帷	司馬云黒林名也本或作惟	source
杏壇	司馬云澤中髙處也李云壇名	commentary
有漁父者	音甫取魚父也一云是范蠡元嘉本作有漁者父則如字	commentary
須眉	本亦作鬚眉	source
交白	如字李云俱也一本作皎	commentary
揄	音遥又音俞又褚由反謂垂手衣内而行也李音投投揮也又士由反	_
袂	面世反李音芮	_
以上	時掌反	source
距陸	李云距至也	commentary
飾禮	如字本又作飭音敕	source
下以化齊民	李云齊等也許愼云齊等之民也如淳云齊民猶平民元嘉本作化於齊民後句如無於字	_
君與	音餘下同	commentary
以危	危或作僞	source
其分	如字本又作介音界司馬云離也	commentary
杖	直亮反	source
挐	女居反司馬云橈也音饒	commentary
郷而	香亮反或作嚮同	commentary
緒言	猶先言也	source
竊待	待或作侍	_
咳	苦代反	commentary
唾	吐臥反	source
相丘	息亮反	commentary
曰嘻	香其反	source
之好	呼報反下同	commentary
丘少	詩召反下同	source
而經子之所以	經經營也司馬云經理也	source
正治	直吏反下官事不治同	source
不屬	音燭	source
長少	丁丈反後遇長同	source
不勝	音升	source
行不	下孟反	commentary
工技	其綺反	_
貢職	職或作賦	source
春秋後倫	朝覲不及等比也	commentary
不飭	音敕	source
不泰	本又作大音同徐敕佐反後同	source
八疵	祀知反	source
之揔	李云謂監也	_
道言	音導	source
稱譽	音餘	source
以敗	補邁反	source
惡人	烏路反下同	source
之慝	他得反	source
善否	悲美反惡也又方九反	commentary
兩容頰適	善惡皆容顔貌調適也頰或作顔	source
以挂	音卦別也又音圭	source
之叨	吐刀反	commentary
很	胡懇反	_
能去	起吕反	commentary
愀然	在九反又七小反	commentary
難語	魚據反下同本或作悟	_
愈數	音朔	source
不離	力智反	source
故強	其丈反下同	source
歡樂	音洛下同	source
禄禄	如字又音録謂形見爲禮也司馬云録領録也	commentary
蚤	音早字亦作早	source
湛	丁南反下同	commentary
丘得過也	謂得過失也過或作遇	_
而比	如字謂親見比數也又毗志反	source
乃刺	七亦反	source
波定	李云謂戰如波也案謂船行故水波去逺則波定	commentary
旁車	歩浪反	source
萬乗	繩證反下同	source
倨	音據	source
敖	五報反	_
曲要	一遥反	source
磬折	之設反	source
湛於	湛或作其	source
下人	遐嫁反下及注同	commentary
而閒	音閑	_
蝡	如兖反	_