春秋公羊經傳解詁僖公第五何休學元年春王正月公何以不言即位	据文公言即位
繼弒君子不言即位此非子也其稱子何	僖公者閔公庶兄据閔公繼子般傳不言子〇弑申志反
臣子一例也	僖公繼成君閔公繼未踰年君禮諸侯臣諸父兄弟以臣之繼君猶子之繼父也其服皆斬衰故傳稱臣子一例○衰七雷反
〇齊師宋師曹師次子聶北救邢救不言次此其言次何	据夏師救齊不言次○聶女渉反
不及事也不及事者何邢巳亡矣	刺其救急舒緩使至於亡故録之止次以起之
孰亡之蓋狄滅之	以上有狄伐邢
曷爲不言狄滅之	据狄滅温言滅
爲桓公諱也曷爲爲桓公諱	据徐人取舒晉滅夏陽楚滅黄皆不諱〇爲桓于僞反下爲桓曷爲井下注爲諱爲桓爲内爲僖皆同夏户雅反
上無天子下無方伯天下諸侯有相滅亡者桓公不能救則桓公恥之	故以爲諱所以醇其能以治丗自任而厚責之
曷爲先言次而後言救	据叔孫豹先言救
君也	叔孫豹臣也當先通君命故先言救今此先言次知實諸侯
君則其稱師何不與諸侯專封也	故没君文但舉師而已
曷爲不與	据狄滅之爲桓公諱
實與	不書所封歸是也
而文不與文曷爲不與	据實與也
諸侯之義不得專封也	此道大平制〇大音泰
諸侯之義不得專封則其曰實與之何上無天子下無方伯天下諸侯有相滅亡者力能救之則救之可也	主書者起文從實也
夏六月邢遷于陳儀遷者何其意也	其意自欲遷時邢創畏狄兵更欲依險阻〇陳儀左氏作夷儀
遷之者何非其意也	謂宋人遷宿也書者譏之也王者封諸侯必居土中所以教化者平貢賦者均在德不在險其後爲衛所滅是也遷例大國月重煩勞也小國時此小國月者霸者所助城故與大國同
齊師宋師曹師城邢此一事也曷爲復言齊師宋師曹師	据首戴前目而後凡〇復言扶又反下同
不復言師則無以知其爲一事也	言諸師則嫌與首戴同嫌實師言諸侯則嫌與縁陵同嫌歸聞其遷更與諸侯來城之未必反故入也故順上文則知桓公宿留城之爲一事也
秋七月戊辰夫人姜氏薨于夷齊人以歸夷者何齊地也齊地則其言齊人以歸何	据從國中歸不當書邾婁人執鄫子不書以歸是也〇鄫似陵反
夫人薨于夷則齊人以歸	夫人所以薨于夷者齊人以歸至夷
夫人薨于夷則齊人曷爲以歸	据上說夫人薨于夷者齊人以歸至夷也齊人曷爲故以歸至于夷
桓公召而縊殺之	先言薨後言以歸而不言喪者起桓公召夫人于邾婁歸殺之于夷因爲内諱恥使若夫人自薨于夷然後齊人以歸者也主書者從内不絶録因見桓公行霸王誅不阿親親疾夫人淫泆二叔殺二嗣子而殺之〇縊一賜反一本作搤於革反見賢徧反泆音逸
楚人伐鄭	楚稱人者爲僖公諱與夷狄交㛰故進使若中國又明嫁娶當慕賢者
八月公㑹齊侯宋公鄭伯曹伯邾婁人于朾	月者危公㑹霸者而與邾婁有辨也不從有夫人喪出㑹惡之者不如危重也○朾勑貞反又他丁反左氏作檉惡之烏路反下同
九月公敗邾婁師于纓	有夫人喪不惡親用兵者時怨邾婁人以夫人與齊於喪事無薄故也○于纓左氏作偃
冬十月壬午公子友帥師敗莒師于犂獲莒拏莒挐者何莒大夫也莒無大夫此何以書大季子之獲也何大乎季子之獲	据獲人當坐○于犂力知反又力兮反左氏作酈莒挐女居反一音女加反一本作茹音同
季子治内難以正	謂拒慶父〇内難乃旦反下同
禦外難以正其禦外難以正奈何公子慶父弑閔公走而之莒莒人逐之將由乎齊齊人不納却反舎于汶水之上使公子奚斯入請季子曰公子不可以入入則殺矣	義不可見賊而不殺
奚斯不忍反命于慶父自南涘	涘水涯〇涘音俟
北面而哭	時慶父自汶水之北
慶父聞之曰嘻	嘻發痛語首之聲○嘻許其反
此奚斯之聲也諾巳	諾巳皆自畢語
曰吾不得入矣於是抗輈經而死	輈小車轅兾州以北名之云爾○輈竹由反車轅也
莒人聞之曰吾巳得子之賊矣以求賂乎魯	魯時雖緩追猶外購求之○購古豆反
魯人不與爲是興師而伐魯	故與季子獲之
季子待之以偏戰	傳云爾者善季子忿不加暴得君子之道
十有二月丁巳夫人氏之喪至自齊夫人何以不稱姜氏	据薨于夷稱姜氏經有氏不但問不稱姜并言氏者嫌据夫人婦姜欲使去氏〇去起吕反
貶曷爲貶	据薨于夷不貶
與弑公也	與慶父共弑閔公〇與殺音預又如字下申志反
然則曷爲不於弑焉貶	据酖牙於卒時貶
貶必於重者莫重乎其以喪至也	刑人于市與衆棄之故必於臣子集迎之時貶之所以明誅得其罪因正王法所加臣子不得以夫人禮治其喪也貶置氏者殺子差輕於殺夫别逆順也致者從書薨以常文録之言自齊者順上以歸文○差初賣反又初佳反别彼列反
二年春王正月城楚丘孰城	据内城不月故問之
城衛也曷爲不言城衛	据無遷文以言城故當言城衛
滅也孰滅之蓋狄滅之	以上有狄入衛
曷爲不言狄滅之爲桓公諱也曷爲爲桓公諱上無天子下無方伯天下諸侯有相滅亡者桓公不能救則桓公恥之也然則孰城之	据不出主名見桓公德優不待之又不獨書齊實諸侯也〇爲桓乎僞反下爲桓曷爲注深爲同見桓賢徧反下傳荀息見并注同
桓公城之曷爲不言桓公城之不與諸侯專封也曷爲不與實與而文不與文曷爲不與諸侯之義不得專封諸侯之義不得專封則其曰實與之何上無天子下無方伯天下諸侯有相滅亡者力能救之則救之可也	復發傳者君子樂道人之善也不繫衛者明去衛而國楚亡起其遷也不書遷與救次者深爲桓公諱使若始時尚倉卒有所救其後晏然無干戈之患所以重其任而厚責之主書者起文從實也〇復扶又反卒寸忽反
夏五月辛巳葬我小君哀姜哀姜者何莊公之夫人也	誅當絶不當以夫人禮書葬書葬者正齊桓討賊辟責内讎齊
○虞師晉師滅夏陽虞微國也曷爲序乎大國之上	据稱師有加文知不主㑹〇夏陽左氏作下陽
使虞首惡也曷爲使虞首惡	据楚人巴人滅庸不使巴首惡
虞受賂假滅國者道以取亡焉其受賂奈何獻公朝諸大夫而問焉曰寡人夜者寢而不寐其意也何諸大夫有進對者曰寢不安與其諸侍御有不在側者與獻公不應荀息進曰虞郭見與	猶曰虞郭豈見於君之心乎荀息素知獻公欲伐此二國故云爾○安與音餘下者與見與同應應對之應郭音虢又如字注及下同
獻公揖而進之	以手通指曰揖
遂與之入而謀曰吾欲攻郭則虞救之攻虞則郭救之如之何願與子慮之荀息對曰君若用臣之謀則今日取郭而明日取虞爾君何憂焉獻公曰然則奈何荀息曰請以屈産之乗	屈産出名馬之地乗備駟也〇屈具物反之乗繩證反注及下同
與垂棘之白璧	垂棘出美玉之地玉以尚白爲美○棘一本作蕀音同
往必可得也則寳出之内藏藏之外府	如虞可得猶外府藏也〇内藏才浪反注同
馬出之内廐繫之外廐爾君何喪焉獻公曰諾雖然宫之竒存焉如之何荀息曰宮之竒知則知矣	君欲言其知實知也○廐九又反喪息浪反知則音智下及注同
雖然虞公貪而好寳見寳必不從其言請終以往於是終以往虞公見寳許諾宫之竒果諫記曰脣亡則齒寒	記史記也〇好呼報反
虞郭之相救非相爲賜	賜猶惠也
則晉今日取郭而明日虞從而亡爾君請勿許也虞公不從其言終假之道以取郭	明郭非虞不滅虞當坐滅人
還四年反取虞	還復往故言反
虞公抱寳牽馬而至荀息見曰臣之謀何如獻公曰子之謀則巳行矣寳則吾寳也雖然吾馬之齒亦巳長矣蓋戲之也	以馬齒長戲之喻荀息之年老傳極道此者以終荀息宮之竒言且以爲戒又惡獻公不仁以滅人爲戲謔也晉至此乃見者著晉楚俱大國後治同姓也以滅人見義者比楚先治大惡親䟽之别〇牽馬本又作掔音同巳長丁丈反注同惡烏路反謔許略反别彼列反
夏陽者何郭之邑也曷爲不繫于郭國之也曷爲國之君存焉爾○秋九月齊侯宋公江人黄人盟于貫澤江人黄人者何逺國之辭也	桓公德盛不嫌使微者知以逺國辭稱人〇貫澤古亂反二傳無澤字
逺國至矣則中國曷爲獨言齊宋至爾大國言齊宋逺國言江黄則以其餘爲莫敢不至也	晉大于宋不序晉而序宋者時實晉楚之君不至君子成人之美故襃益以爲徧至之辭所以將大大霸功而勉盛徳也江黄附從霸者當進不進者方爲徧至之辭○徧至音遍下同
〇冬十月不雨何以書記異也	說與前同
楚人侵鄭三年春王正月不雨○夏四月不雨何以書記異也	大平一月不雨即書春秋亂丗一月不雨未害物未足爲異當滿一時乃書一月書者時僖公得立欣喜不恤庶衆比致三旱即能退辟正殿飭過求巳循省百官放佞臣郭都等理冤獄四百餘人精誠感天不雩而得澍雨故一月即書善其應變改政旱不從上發傳者著人事之備積於是〇大平音泰飭過音勑下同冤於元反澍之樹反其應應對之應後災祥之應皆放此
〇徐人取舒其言取之何	据國言滅
易也	易者猶無守禦之備不爲桓諱者刺其不救也○易以䜴反注同爲于僞反
六月雨其言六月雨何	据上得雨不書
上雨而不甚也	所以詳録賢君精誠之應也僖公飭過求巳六月澍雨宣公復古行中其年榖大豐明天人相與報應之際不可不察其意
秋齊侯宋公江人黄人㑹于陽榖此大㑹也曷爲末言爾	末者淺耳但言㑹不也盟据貫澤言盟
桓公曰無障谷	無障斷川谷專水利也水注川曰溪注溪曰谷〇障之亮反一音章注同斷丁管反溪口兮反
無貯粟	有無當相通〇貯中吕反
無易樹子	樹立本正辭無易本正當立之子
無以妾爲妻	此四者皆時人所患時桓公功德隆盛諸侯咸曰無言不從曷爲用盟哉故告誓而已
○冬公子友如齊莅盟莅盟者何往盟乎彼也	猶曰往盟於齊莅臨也時因齊都盟主國主名不出者春秋王魯故言莅以見王義使若王者遣使臨諸侯盟飭以法度〇莅音利又音類注同以見賢徧反下同遣使所吏反
其言來盟者何來盟于我也	此亦因魯都以見王義使若來之京師盟白事于王不加莅者來就魯魯巳尊矣
○楚人伐鄭四年春王正月公㑹齊侯宋公陳侯衛侯鄭伯許男曹伯侵蔡蔡潰潰者何下叛上也國曰潰邑曰叛	不與諸侯潰之爲文重出蔡者侵爲加蔡舉潰爲惡蔡録義各異也月者善義兵也潰例月叛例時○蔡潰户内反下及注同重直用反惡蔡烏路反下惡其專并六年注同
遂伐楚次于陘其言次于陘何	据召陵侵楚不言次來盟不言陘○陘音刑召陵上照反下文同
有俟也孰俟俟屈完也	時楚強大卒暴征之則多傷士衆桓公先犯其與國臨蔡蔡潰兵精威行乃推以伐楚楚懼然後使屈完來受盟脩臣子之職不頓兵血刃以文德優柔服之故詳録其止次待之善其重愛民命生事有漸故敏則有功〇屈居勿反卒寸忽反
夏許男新臣卒	不言卒於師者桓公師無危不月者爲下盟去月方見大信○爲于僞反下爲桓公同去起吕反見賢徧反
○楚屈完來盟于師盟于召陵屈完者何楚大夫也何以不稱使	据陳侯使袁僑如㑹〇僑其驕反一本作驕音同
尊屈完也曷爲尊屈完	据陳侯使袁僑如㑹不尊之
以當桓公也	増倍使若得其君以醇霸德成王事也
其言盟于師盟于召陵何	据戊寅叔孫豹及諸侯之大夫及陳袁僑盟不舉㑹與地
師在召陵也	時喜得屈完來服於陘即退次召陵與之盟故也盟于師盟于召陵
師在召陵則曷爲再言盟	据齊侯使國佐如師已酉及國佐盟汙袁婁俱從地不再言盟
喜服楚也	孔子曰書之重辭之復嗚呼不可不察其中必有美者焉〇重直用反又直容反之復扶又反年末乃復同又音福
何言乎喜服楚	据服蔡無喜文
楚有王者則後服	桓公行霸至是乃服楚
無王者則先叛	桓公不脩其師先叛盟是也
夷狄也而亟病中國	數侵滅中國○亟去兾反數音朔
南夷與北夷交	南夷謂楚滅鄧榖伐蔡鄭北夷謂狄滅邢衛至于温交亂中國
中國不絶若綫	綫縫帛縷以喻微也〇綫思賤反
桓公救中國	存邢衛是也
而攘夷狄	攘却也北伐山戎是也○攘如羊反却也
卒怗荆	卒盡也怗服也荆楚也○怗他恊反一本作貼服也劉兆同廣雅云靜也玉篇又丁簟反一本作拈或音章貶反
以此爲王者之事也	言桓公先治其國以及諸夏治諸夏以及夷狄如王者爲之故云爾
其言來何	据陳袁僑如㑹不言來
與桓爲主也	以從内文知與桓公爲天下霸主
前此者有事矣	謂城邢衛是也
後此者有事矣	謂城縁陵是也
則曷爲獨於此焉與桓公爲主序績也	序次也績功也累次桓公之功德莫大於服楚明德及強夷最爲盛
○齊人執陳袁濤塗濤塗之罪何辟軍之道也其辟軍之道奈何濤塗謂桓公曰君旣服南夷矣何不還師濵海而東服東夷且歸	濵涯也順海涯而東也東夷呉也從召陵東歸不經陳而趨近海道多廣澤水草軍所便也〇濤徒刀反辟匹亦反又音避下同濵音賔涯五佳反近附近之近便婢面反
桓公曰諾於是還師濵海而東大䧟于沛澤之中	草棘曰沛漸洳曰澤○沛澤音貝又普貝反草棘曰沛漸洳曰澤漸子廉反洳人庶反
顧而執濤塗	時濤塗與桓公俱行
執者曷爲或稱侯或稱人稱侯而執者伯討也	言有罪方伯所宜討
稱人而執者非伯討也此執有罪何以不得爲伯討古者周公東征則西國怨西征則東國怨	此道黜陟之時也詩云周公東征四國是皇
桓公假塗于陳而伐楚則陳人不欲其反由已者師不正故也	故令濤塗有此言○令力呈反
不脩其師而執濤塗古人之討則不然也	以已所招而反執人古人所不爲也凡書執者惡其專執
秋及江人黃人伐陳〇八月公至自伐楚楚巳服矣何以致伐楚叛盟也	爲桓公不脩其師而執濤塗故也月者凡公出滿二時月危公之乆
○葬許繆公	得卒葬於所傳聞丗者許大小次曹故卒少在曹後○傳丈專反
冬十有二月公孫慈帥師㑹齊人宋人衛人鄭人許人曹人侵陳	月者刺桓公不脩其師因見患誑不内自責乃復加之以罪○慈左氏作兹誑九況反
五年春晉侯殺其丗子申生曷爲直稱晉侯以殺	据鄭殺其大夫申侯稱國也續問以殺者問殺所稱例爾非謂晉侯不當稱國爵也
殺丗子母弟直稱君者甚之也	甚之者甚惡殺親親也春秋公子貫於先君唯丗子與母弟以今君録親親也今舎國體直稱君知以親親責之〇舎音捨
○𣏌伯姬來朝其子其言來朝其子何	据微者不當書朝連來者内辭也與其子來者問爲直來乎爲下朝出○爲下于僞反
内辭也與其子俱來朝也	因其與子俱來禮外孫初冠有朝外祖之道故使若來朝其子以殺直來之恥所以辟教戒之不明也微無君命言朝者明非實〇冠古亂反
夏公孫慈如牟	〇牟莫侯反
〇公及齊侯宋公陳侯衛侯鄭伯許男曹伯㑹王丗子于首戴曷爲殊㑹王丗子	据宰周公不殊别也〇首戴左氏作首止别彼列反
丗子貴也丗子猶丗丗子也	解貴意也言當丗父位儲君副主不可以諸侯㑹之爲文故殊之使若諸侯爲丗子所㑹也自王者言之以屈逺丗子在三公下禮喪服斬衰曰公士大夫之衆臣是也自諸侯言之丗子尊於三公此禮之威儀各有所施言及者因其文可得見汲汲也丗子所以㑹者時桓公德衰諸侯背叛故上假王丗子示以公義
秋八月諸侯盟于首戴諸侯何以不序	据上㑹序
一事而再見者前目而後凡也	省文從可知間無事不省諸侯㑹盟一事不舉重者時丗子不與盟〇見賢徧反省文所景反下同與音預
鄭伯逃歸不盟其言逃歸不盟者何	据上言諸侯鄭伯在其中弟子疑故執不知問
不可使盟也	時鄭伯内欲與楚外依古不盟爲解安居㑹上不肯從桓公盟故後言不盟〇解古賣反
不可使盟則其言逃歸何	据後言不盟居㑹上辭
魯子曰蓋不以寡犯衆也	諸侯以義相約而鄭伯懷二心依古不肯盟故言逃歸所以抑一人之惡申衆人之善故云爾
〇楚人滅弦弦子奔黃○九月戊申朔日有食之	此象齊桓德衰是後楚遂背叛狄伐晉滅温晉里克比弒其二君○比殺申志反
○冬晉人執虞公虞已滅矣其言執之何	据滅言以歸上傳云四年反取虞知去滅變以歸言執〇去起呂反下同
不與滅也曷爲不與滅滅者亡國之善辭也	言滅者王者起當存之故爲善辭
滅者上下之同力者也	言滅者臣子與君戮力一心共死之辭也不但去滅復去以歸言執者明虞公滅人以自亡當絶不得責不死位也晉稱人者夲滅而執之不以王法執治之故從執無罪辭也虞稱公者奪正爵起從滅也不從滅例月者略之○戮音六又作戮力彫反
六年春王正月○夏公㑹齊侯宋公陳侯衛侯曹伯伐鄭圍新城邑不言圍此其言圍何彊也	惡桓公行霸彊而無義也鄭背叛本由桓公過陳不以道理當先脩文德以來之而便伐之彊非所以附䟽〇彊也其良反
〇秋楚人圍許諸侯遂救許○冬公至自伐鄭	事遷於救許以伐鄭致者舉不得意
七年春齊人伐鄭〇夏小邾婁子來朝	至是所以進稱爵者時附從霸者朝天子旁朝罷行進齊相公白天子進之固因其得禮著其能以爵通
〇鄭殺其大夫申侯其稱國以殺何	据晉侯殺其出子申生稱侯
稱國以殺者君殺大夫之辭也	諸侯國體以大夫爲股肱士民爲肌膚故以國體録
秋七月公㑹齊侯宋公陳丗子𣢾鄭丗子華盟于寗母	〇款苦管反毋音無或音某
〇曹伯般卒〇公子友如齊〇冬葬曹昭公八年春王正月公㑹王人齊侯宋公衛侯許男曹伯陳丗子𣢾鄭丗子華盟于洮王人者何微者也曷爲序乎諸侯之上先王命也	銜王命㑹諸侯諸侯當北面受之故尊序於上時桓公德衰寗母之盟常㑹者不至而陳鄭又遣丗子故上假王人之重以自助〇洮他刀反
鄭伯乞盟乞盟者何處其所而請與也	以不序也
其處其所而請與奈何蓋酌之也	酌挹也時鄭伯欲與楚不肯自來盟處其國遣使挹取其血而請與之約束無汲汲慕中國之心故抑之使若叩頭乞盟者也不録使者方抑鄭伯使若自來也不盟不爲大惡者古者不盟也〇遣使所吏反下録使同
〇夏狄伐晉○秋七月禘于大廟用致夫人用者何用者不宜用也致者何致者不宜致也禘用致夫人非禮也	以致文在廟下不使入廟知非禮也禮夫人始見廟當特祭而因禘諸公廟見欲以省煩勞不謹敬故譏之不日者下用失禮明〇大音泰始見賢徧反下同省所景反
夫人何以不稱姜氏貶曷爲貶	据夫人姜氏入不貶
譏以妾爲妻也	以逆不書入廟當稱婦姜而稱夫人者夫人當坐篡嫡也妾之事嫡猶臣之事君同〇篡嫡𥘉患反下音的下同
其言以妾爲妻奈何蓋脅于齊媵女之先至者也	以不致楚女及夫人至皆不書也僖公本聘楚女爲嫡齊女爲媵齊先致其女脅僖公使用爲嫡故從父母辭言致不書夫人及楚女至者起齊先致其女然後脅魯立也楚女未至而豫廢故皆不得以夫人至書也
○冬十有二月丁未天王崩	惠王也
九年春王三月丁丑宋公禦說卒何以不書葬爲襄公諱也	襄公背殯出㑹宰周公有不子之惡後有征齊憂中國尊周室之心功足以除惡故諱不書葬使若非背殯也○說音恱爲襄于僞反下注爲天爲桓皆同
○夏公㑹宰周公齊侯宋子衛侯鄭伯許男曹伯于葵丘宰周公者何天子之爲政者也	宰猶治也三公之職號尊名也以如宰知其職大尊重當與天子參聽萬機而下爲諸侯所㑹惡不勝其任也宋未葬不稱子某者出㑹諸侯非尸柩之前故不名○惡不烏路反勝音升
○秋七月乙酉伯姬卒此未適人何以卒	据𣏌叔姬不卒
許嫁矣婦人許嫁字而笄之	字者尊而不泄所以逺别也笄者簪也所以繫持髪象男子飾也服此者明繫屬於人所以養貞一也㛰禮曰女子許嫁笄而醴之稱字○笄古兮反泄息列反别彼列反簪莊林反
死則以成人之喪治之	不以殤禮降也許嫁卒者當爲諸侯夫人有即貴之漸猶俠卒也日者恩尤重於未命大夫故從諸侯夫人例○俠音協
〇九月戊辰諸侯盟于葵丘桓之盟不日此何以日危之也何危爾貫澤之㑹桓公有憂中國之心不召而至者江人黄人也葵丘之㑹桓公震而矜之叛者九國	下伐厲善義兵是也㑹不書者叛也叛不書者爲天子親遣三公㑹之而見叛故上爲天子下爲桓公諱也㑹盟一事不舉重者時宰周公不與盟○不預音豫
震之者何猶曰振振然	亢陽之貌
矜之者何猶曰莫若我也	色自美大之貌
甲戍晉侯詭諸卒	不書葬者殺丗子也〇詭九委反
○冬晉里克弑其君之子奚齊此未踰年之君其言弑其君之子奚齊何	据弒其君舎不連先君連名者上不書葬子某弑君名未明也〇殺其音試下及注放此
弑未踰年君之號也	欲言弒其子奚齊嫌無君文與殺大夫同欲言弒其君又嫌與弒成君同故引先君冠子之上則弑未踰年君之號定而坐之輕重見矣加之者起先君之子不解名者解言殺從弑名可知也弑未踰年君例當月不月者不正遇禍終始惡明故略之○冠古亂反見賢徧反
十年春王正月公如齊	書如者録内所與外交接也故如京師善則月榮之如齊晉善則月安之如楚則月危之明當尊賢慕大無友不如巳者月者僖公本齊所立桓公德衰見叛獨能念恩朝事之故善録之
秋滅温○温子奔衛○晉里克弑其君卓子及其大夫荀息及者何累也弑君多矣舎此無累者乎曰有孔父仇牧皆累也舎孔父仇牧無累者乎曰有有則此何以書賢也何賢乎荀息	据與孔父同〇君卓子勑角反又丁角反左氏經無子字舎音捨下同
荀息可謂不食其言矣	不食言者不如食受之而消亡之以奚齊卓子皆立
其不食其言奈何奚齊卓子者驪姬之子也荀息傅焉	禮諸侯之子八歳受之少傅教之以小學業小道焉履小節焉十五受大傳教之以大學業大道焉履大節焉○驪力知反少詩照反大傅音泰
驪姬者國色也	其顔色一國之選〇選息戀反
獻公愛之甚欲立其子於是殺丗子申生申生者里克傅之獻公病將死謂荀息曰士何如則可謂之信矣	獻公自知廢正當有後患欲託二子於荀息故動之云爾
荀息對曰使死者反生生者不愧乎其言則可謂信矣	荀息察言觀色知獻公欲爲奚齊卓子來動巳故荅之云爾○欲爲于僞皮下文爲文公不爲故爲皆同
獻公死奚齊立里克謂荀息曰君殺正而立不正廢長而立㓜	長謂重耳〇長丁丈反注同
如之何願與子慮之荀息曰君甞訊臣矣	上問下曰訊言臣者明君臣相與言不可負〇訊音信上問下曰訊
臣對曰使死者反生生者不愧乎其言則可謂信矣里克知其不可與謀退弑奚齊荀息立卓子里克弑卓子荀息死之荀息可謂不食其言矣	起時莫不背死郷生去敗與成荀息一受君命終身死之故言及與孔父同義不日者不正遇禍終始惡明故略之○背音佩郷許亮反
夏齊侯許男伐北戎○晉殺其大夫里克里克弑二君則曷爲不以討賊之辭言之	据衛人殺州吁
惠公之大夫也	惠公篡立已定晉國君臣合爲一體無所復責故曰此乃惠公之大夫安得以討賊之辭言之〇所復扶又反下同
然則孰立惠公	欲難殺之意〇難乃旦反
里克也里克弑奚齊卓子逆惠公而入里克立惠公則惠公曷爲殺之惠公曰爾旣殺夫二孺子矣	孺子小子也奚齊卓子時皆㓜小○夫音扶孺如住反
又將圖寡人	如我有不可將復圖我如二孺子
爲爾君者不亦病乎於是殺之然則曷爲不言惠公之入	据齊小白入于齊
晉之不言岀入者踊爲文公諱也	踊豫也齊人語若關西言渾矣獻公殺申生文公與惠公恐見及出奔不子當絶還入爲篡文公功足以并掩前人之惡故惠公入懷公出文公入渾皆不書悉爲文公諱故也爲文公諱者欲明文公之功大也語在下懷公者惠公子也惠公卒懷公立而秦納文公故出奔惠公文公出奔不書者非命嗣也〇踊音勇豫也言渾户昆反又户本反下同
齊小白入于齊則曷爲不爲桓公諱桓公之享國也長	享食
美見乎天下故不爲之諱本惡也文公之享國也短美未見乎天下故爲之諱夲惡也	桓公功大善惡相除足封有餘較然爲天下所知文公功少嫌未足除身篡而有封功故爲之諱并不言惠公懷公出入者明非徒足以除身篡而巳有足封之明較也美不如桓公之功大〇美見賢徧反下同較然音角下同
○秋七月〇冬大雨雹何以書記異也	夫人專愛之所生也〇南于付反雹歩角反
十有一年春晉殺其大夫㔻鄭父	〇㔻普悲反
夏公及夫人姜氏㑹齊侯于陽榖○秋八月大雩	公與夫人出㑹不恤民之應
〇冬楚人伐黃十有二年春王三月庚午日有食之	是後楚滅黄狄侵衛
○夏楚人滅黄秋七月○冬十有二月丁丑陳侯處臼卒	〇處臼左氏作杵臼
十有三年春狄侵衛○夏四月葬陳宣公〇公㑹齊侯宋公陳侯衛侯鄭伯許男曹伯于鹹	桓公自貫澤陽榖之㑹後所以不復舉小國者從一法之後小國言從令行大國唯曹許以上乃㑹○鹹音咸不復扶又反下同
○秋九月大雩	田陽榖之㑹不恤民復㑹于鹹城縁陵煩擾之應
○冬公子友如齊十有四年春諸侯城縁陵孰城之	諸侯不序故問誰城
城𣏌也曷爲城𣏌滅也孰滅之蓋徐莒脅之	以下皆狄徐也言脅者𣏌王者之後尤微是見恐曷而亡○恐丘勇反曷火葛反
曷爲不言徐莒脅之爲桓公諱也曷爲爲桓公諱上無天子下無方伯天下諸侯有相滅亡者桓公不能救則桓公恥之也然則孰城之桓公城之曷爲不言桓公城之不與諸侯專封也曷爲不與實與而文不與文曷爲不與諸侯之義不得專封也諸侯之義不得專封則其曰實與之何上無天子下無方伯天下諸侯有相㓕亡者力能救之則救之可也	輙發傳者與城衛同義言諸侯者時桓公德衰待諸侯然後乃能存之外城不月者文言諸侯非内城明矣〇爲桓于僞反下爲桓爲天下并注臣爲同
〇夏六月季姬及鄫子遇于防使鄫子來朝鄫子曷爲使乎季姬來朝	据使者臣爲君銜命文也
内辭也非使來朝使來請已也	使來請娶已以爲夫人下書歸是也禮男不親求女不親許魯不防正其女乃使要遮鄫子淫泆使來請已與禽獸無異故卑鄫子使乎季姬以絶賤之也月者甚惡内也〇要一遥反遮諸奢反泆音逸惡烏路反
〇秋八月辛卯沙鹿崩沙鹿者何河上之邑也此邑也其言崩何	据梁山言崩
襲邑也	襲者嘿陷入于地中言崩者以在何上也河岸有髙下如山有地矣故得言崩也
沙鹿崩何以書記異也外異不書此何以書	据長狄之齊晉不書
爲天下記異也	土地者民之主霸者之象也何者隂之精爲下所襲者此象天下異齊桓將卒霸道毀夷狄動宋襄承其業爲楚所敗之應而不擊國者起天下異
○狄侵鄭○冬蔡侯肸卒	不書葬者潰當絶也不月者賤其背中國而附父雔故略之甚也肸立不書者父獻舞見獲留卒於楚肸以次立非篡也○肸許乙反注同背音佩
十有五年春王正月公如齊	月者善公旣能念恩尊事齊桓又合古五年一朝之義故録之
楚人伐徐〇三月公㑹齊侯宋公陳侯衛侯鄭伯許男曹伯盟于牡丘遂次于匡公孫敖率師及諸侯之大夫救徐	言次者刺諸侯緩於人恩旣約救徐而生事止次不自往遣大夫往卒不能解也大夫不序者起㑹上大夫君巳目故臣凡也内獨出名氏者臣不得因君殊尊省文别尊卑也○别彼列反
夏五月日有食之	是後秦獲晉侯齊桓公卒楚執宋公霸道衰中國微弱之應
〇秋七月齊師曹師伐厲	月者善録義兵厲葵丘之㑹叛天子之命也曹稱師者桓公霸道衰曹獨能從之征伐不義故褒之所以勸勉不能扶助霸功激揚解惰也○厲如字舊音賴激古歷反解古賣反隋也徒卧反
八月􁈰	公乆出煩擾之所生〇􁈰之戎反
○九月公至自㑹桓公之㑹不致此何以致	据柯之㑹不致
乆也	乆暴師衆過三時〇暴歩卜反
○季姬歸于鄫○已卯晦震夷伯之廟晦者何冥也	晝日而冥○冥亡丁反又亡定反注同
震之者何雷電擊夷伯之廟者也夷伯者曷爲者也季氏之孚也	孚信也季氏所信任臣
季氏之孚則微者其稱夷伯何大之也曷爲大之	据陽虎稱盗
天戒之故大之也	明此非但爲微者異乃公家之至戒故尊大之使稱字過于大夫以起之所以畏天命孔子曰君子有三畏畏天命畏大人畏聖人之言
何以書記異也	此象桓公德衰彊楚以邪勝正僖公蔽於季氏季氏蔽於陪臣陪臣見信得權僭立大夫廟天意若曰蔽公室者是人也當去之〇去起吕反
○冬宋人伐曹○楚人敗徐于婁林	謂之徐者爲滅𣏌不知尊先聖法度惡重故狄之也不月者略兩夷狄也○爲于僞反
○十有一月壬戍晉侯及秦伯戰于韓獲晉侯此偏戰也何以不言師敗績	据泓之戰言宋師敗績〇泓烏宏反
君獲不言師敗績也	舉君獲爲重也釋不書者以獲君爲惡書者以惡見獲與獲人君者皆當絶也主書者從獲人例〇惡烏路反
十有六年春王正月戊申朔霣石于宋五是月六鷁退飛過宋都曷爲先言霣而後言石	据星霣後言霣〇十六年本或從此下别爲卷案七志七録何注止十一卷公羊以閔附莊故也後人以僖卷大輙分之爾霣于敏反是月如字或一音徒兮反六鶂五歷反水鳥
霣石記聞聞其磌然視之則石察之則五是月者何僅逮是月也	是月邊也魯人語也在正月之幾盡故曰劣及是月也〇磌然之人反又大年反聲響也一音芳君反本或作砰八耕反僅其靳反劣也逮音代又大計反及也幾音祈
何以不日	据五石言日
晦日也	凡災異晦日不日日食是也日食常於晦朔不日晦可知也六鷁無常故言是月以起晦也
晦則何以不言晦	据上言朔
春秋不書晦也	事當日者日平居無他卓佹無所求取言晦朔也趡盟奚戰是也〇佹尤委反趡翠軌反
朔有事則書	重始故書以録事若泓之戰及此皆是也
晦雖有事不書	重始而終自正故不復書以録事〇不復扶又反下同
曷爲先言六而後言鷁	据霣石後言五
六鷁退飛記見也視之則六察之則鷁徐而察之則退飛	鷁小而飛髙故視之如此事勢然也宋都者宋國所治也人所聚曰都言過宋都者時獨過宋都退飛○所治直吏反
五石六鷁何以書記異也外異不書此何以書爲王者之後記異也	王者之後有亡徴非親王安存之象故重録爲戒記災異也石者隂德之專者也鷁者鳥中之耿介者皆有似宋襄公之行襄欲行霸事不納公子目夷之謀事事耿介自用卒以五年見執六年終敗如五石六鷁之數天之與人昭昭著明甚可畏也於晦朔者示其立功善甫始而敗將不克終故詳録天意也○爲王于僞反注同耿介音戒之行下孟反
○三月壬申公子季友卒其稱季友何	据犂戰名不稱季來歸不稱友
賢也	閔公不書葬故復於卒賢之明季子當蒙討慶父之功遏牙存國終當録也不稱子者上歸本當稱字起事言子
〇夏四月丙申鄫季姬卒○秋七月甲子公孫慈卒	日者僖公賢君宜有恩禮於大夫故皆日也一年喪骨肉三人故曰痛之
〇冬十有二月公㑹齊侯宋公陳侯衞侯鄭伯許男邢侯曹伯于淮	月者危桓公德衰任竪刀易牙墮功滅項自此始也〇墮許規反
十有七年春齊人徐人伐英氏	稱氏者春秋前黜稱氏也伐國而舎氏言之者非主名故伐之得從國舉
○夏滅項孰滅之齊滅之	以言滅知非内也以不諱知齊滅○項户講反國名
曷爲不言齊滅之	据齊師滅譚
爲桓公諱也春秋爲賢者諱此滅人之國何賢爾君子之惡惡也疾始	絶其始則不得終其惡〇爲桓于僞反下及注同惡惡並如字一讀上烏路反
善善也樂終	樂賢者終其行〇行下孟反
桓公甞有繼絶	立僖公也
存亡之功	存邢衛𣏌
故君子爲之諱也	言甞者時桓公德衰功廢而滅人嫌當坐故上述所甞盛美而爲之諱所以尊其德彰其功傅不言服楚獨舉繼絶存亡者明繼絶存亡足以除殺子糾滅譚遂項覆終身之惡服楚功在覆篡惡之表所以封桓公各當如其事也不月者桓公不坐滅略小國
秋夫人姜氏㑹齊侯于卞	〇卞皮彦反
九月公至自㑹〇冬十有二月乙亥齊侯小白卒十有八年春王正月宋公㑹曹伯衛人邾婁人伐齊	月者與襄公之征齊善録義兵
夏師救齊五月戊寅宋師及齊師戰于甗齊師敗績戰不言伐此其言伐何宋公與伐而不與戰故言伐春秋伐者爲客伐者爲主曷爲不使齊主之	据甲寅衛人及齊人戰○甗魚輦反又音言與伐音預下不與同
與襄公之征齊也曷爲與襄公之征齊	据齊桓公霸者猶不與征衛
桓公死豎刀易牙爭權不葬爲是故伐之也	不爲文實者保伍連率本有用兵征伐不義之道〇刀音彫爲是于僞反注同
〇狄救齊秋八月丁亥葬齊桓公○冬邢人狄人伐衛	狄稱人者善能救齊雖拒義兵猶有憂中國之心故進之不於救時進之者辟襄公不使義兵壅塞
十有九年春王三月宋人執滕子嬰齊	名者著葵丘之㑹叛天子命者也不得爲伯討者不以其罪執之妄執之所以著有罪者爲襄公殺恥也襄公有善志欲承齊桓之業執一惡人不能得其過故爲見其罪所以助賢者養善意也月者録責之〇爲襄于僞反下故爲起爲爲襄公深爲若不爲皆同見賢徧反
夏六月宋人曹人邾婁人盟于曹南	因本㑹于曹南盟故以地實邾婁說在下
鄫子㑹盟于邾婁其言㑹盟何	据外諸侯㑹盟不録及曹伯襄言㑹諸侯
後㑹也	說與㑹伐宋同義君不㑹大夫刺後㑹者起實君也地以邾婁者起爲邾婁事也不言君者爲襄公諱也魯本許嫁季姬於邾婁季姬淫泆使鄫子請已而許之二國交忿襄公爲此盟欲和解之旣在人間反爲邾婁所欺執用鄫子恥辱加於宋無異故没襄公使若微者也不於上地以邾婁者深爲襄公諱使若不爲邾婁事盟而鄫子自就邾婁爲所執者也上盟不日者深順諱文從微者例使若下執不以上盟爲辨也㑹盟不日者言㑹盟不信巳明無取於日自其正文也
已酉邾婁人執鄫子用之惡乎用之用之社也其用之社奈何蓋叩其鼻以血社也	惡無道也不言社者本無用人之道言用之巳重矣故絶其所用處也日者魯不能防正其女以至於此明當痛其女禍而自責之〇惡乎音烏惡無烏路反用處昌慮反
秋宋人圍曹衛人伐邢冬公㑹陳人蔡人楚人鄭人盟于齊	因宋征齊有隙爲此盟也是後楚遂得中國霍之㑹執宋公
〇梁亡此未有伐者其言梁亡何	据蔡潰以自潰爲又舉侵也
自亡也其自亡奈何魚爛而亡也	梁君隆刑峻法一家犯罪四家坐之一國之中無不被刑者百姓一旦相率俱去狀若魚爛魚爛從内發故云爾者其自亡者明百姓得去之君當絶者
二十年春新作南門何以書譏何譏爾門有古常也	惡奢泰不奉古制常法○惡烏路反
夏郜子來朝郜子者何	未有存文嫌不名故執不知問〇郜古報反姬姓之國下同
失地之君也何以不名	据鄧榖名
兄弟辭也	郜魯之同姓故不忍言其絶賤明當尊遇之異於鄧榖也書者喜内見歸
五月乙巳西宫災西宫者何小寢也小寢則曷爲謂之西宫有西宫則有東宫矣魯子曰以有西宫亦知諸侯之有三宫也	西宫者小寢内室楚女所居也禮諸侯娶三國女以楚女居西宫知二國女於小寢内各有一宫也故云爾禮夫人居中宫少在前右媵居西宫左媵居東宫少在後
西宫災何以書記災也	是時僖公爲齊所脅以齊媵爲嫡楚女廢在西宫而不見恤悲愁怨曠之所生也言西宮不繫小寢者小寢夫人所統妾之所繫也天意若曰楚女本當爲夫人不當繫於齊女故經亦云爾〇爲適丁歷反又作嫡
〇鄭人入滑○秋齊人狄人盟于邢	狄稱人者能常與中國也
冬楚人伐隨	叛楚故也
二十有一年春狄侵衛	貶狄者爲犯中國諱○爲于僞反下不爲襄下文爲執皆同
宋人齊人楚人盟于鹿上夏大旱何以書記災也	新作南門之所生
秋宋公楚子陳侯蔡侯鄭伯許男曹伯㑹于霍執宋公以伐宋孰執之楚子執之	以下獻捷貶〇霍左氏作盂
曷爲不言楚子執之	据湨梁盟下執莒子邾婁子復出晉人也〇湨古閴反復出扶又反下同
不與夷狄之執中國也	不舉執爲重復舉伐者劫質諸侯求其國事當起也不爲襄公諱者守信見執無恥說在下也
冬公伐邾婁楚人使宜申來獻捷此楚子也其稱人何	据稱使知楚子○捷在反
貶曷爲貶	据齊侯獻戎捷不貶
爲執宋公貶曷爲爲執宋公貶	据上巳没不與執中國
宋公與楚子期以乗車之㑹	蓋鹿上之盟〇乘車繩證反下同
公子目夷諫曰楚夷國也彊而無義請君以兵車之㑹往宋公曰不可吾與之約以乗車之㑹自我爲之自我墮之曰不可終以乗車之㑹往楚人果伏兵車執宋公以伐宋	詐諼劫質諸侯求其國當絶故貶〇墮許規反誰諼誰本亦作詐諼音許元反詐也又音援
宋公謂公子目夷曰子歸守國矣國子之國也吾不從子之言以至乎此公子目夷復曰君雖不言國國固臣之國也	所以堅宋公意絶彊楚之望
於是歸設守械而守國楚人謂宋人曰子不與我國吾將殺子君矣宋人應之曰吾賴社稷之神靈吾國巳有君矣楚人知雖殺宋公猶不得宋國於是釋宋公宋公釋乎執走之衛	襄公本謂公子目夷曰國子之國也宋公愧前語故慙不忍反走之衛不書者執解而往非岀奔也〇守手又反又如字應應對之應
公子目夷復曰國爲君守之君曷爲不入然後逆襄公歸	凡出奔歸書執獲歸不書者出奔巳失國故録還應盗國與執獲者異臣下尚隨君事之未失國不應盗國無爲録也〇國爲于僞反下爲襄爲公子注爲没故爲皆同
惡乎捷捷乎宋	以上言伐宋○惡音烏
曷爲不言捷乎宋	据戎捷也
爲襄公諱也	襄公本㑹楚欲行霸憂中國也不用目夷之言而見詐執伐宋幾亡其國故諱爲没國文所以申善志不月者因起其事〇幾音祈
此圍辭也曷爲不言其圍	据上言守國知圍也
爲公子目夷諱也	目夷遭難設權救君有解圍存國免主之功故爲諱圍起其事所以彰目夷之賢也歸捷書者刺魯受惡人物也○遭難乃旦反
○十有二月癸丑公㑹諸侯盟于薄	言諸侯者起霍之㑹諸侯也不序者起公從旁以議釋宋公㑹盟一事也言㑹者因以殊諸侯也
釋宋公執未有言釋之者此其言釋之何	据執滕子不言釋
公與爲爾也公與爲爾奈何公與議爾也	善僖公能與楚議釋賢者之厄不言公釋之者諸侯亦有力也
二十有二年春公伐邾婁取須朐	〇朐其俱反左氏作句
〇夏宋公衛侯許男滕子伐鄭○秋八月丁未及邾婁人戰于升陘	○陘音刑
〇冬十有一月已巳朔宋公及楚人戰于泓宋師敗績偏戰者日爾此其言朔何	据奚之戰不言朔
春秋辭䌓而不殺者正也	繁多也殺省也正得正道尤美○不殺所戒反注同省所景反
何正爾宋公與楚人期戰于泓之陽	泓水名水北曰陽
楚人濟泓而來	濟渡
有司復曰請迨其未畢濟而擊之	迨及
宋公曰不可吾聞之也君子不厄人吾雖喪國之餘	我雖前幾爲楚所喪所以得其餘民以爲國喻褊弱〇喪國息浪反注同幾音祈
寡人不忍行也旣濟未畢陳有司復曰請迨其未畢陳而擊之宋公曰不可吾聞之也君子不鼓不成列	軍法以鼓戰以金止不鼓不戰不成列未成陳也君子不戰未成陳之師〇畢陳直覲反下及注同
巳陳然後襄公鼓之宋師大敗故君子大其不鼓不成列臨大事而不忘大禮有君而無臣	言朔亦所以起有君而無臣借其有王徳而無王佐也若襄公所行帝王之兵也有帝王之君宜有帝王之臣有帝王之臣宜有帝王之民未能醇粹而守其禮所以敗也〇王德于況反又如字下王佐同醇粹音純下雖遂反
以爲雖文王之戰亦不過此也	有似文王伐崇陸戰當舉地舉水者大其不以水厄乆也
二十有三年春齊侯伐宋圍緡邑不言圍此其言圍何疾重故也	疾痛也重故喻若重故創矣襄公欲行霸守正履倍屬爲楚所敗諸夏之君宜雜然助之反因其困而伐之痛與重故創無異故言圍以惡其不仁也○緡亡巾反重故直用反又直龍反注同故創初良反下同屬音燭雜七合反又如字惡烏路反
○夏五月庚寅宋公慈父卒何以不書葬盈乎諱也	盈滿也相接足之辭也襄公夲以背殯不書其父葬至襄公身書葬則嫌霸業不成所覆者薄故復使身不書葬明當以前諱除背殯以後諱加微封内娶不去日略之者功覆之也〇慈父左氏作茲父復扶又反去起吕反
〇秋楚人伐陳〇冬十有一月𣏌子卒	卒者桓公存王者後功尤美故爲表異卒録之始見稱伯卒獨稱子者微弱爲徐莒所脅不能死位春秋伯子男一也辭無所貶貶稱子者春秋黜𣏌不明故以其一等貶之明本非伯乃公也又因以見聖人子孫有誅無絶故貶不失爵也不名不日不書葬者從小國例也〇始見賢徧反
二十有四年春王正月〇夏狄伐鄭〇秋七月○冬天王出居于鄭王者無外此其言出何	据王子瑕奔晉不言出
不能乎母也	不能事母罪莫大於不孝故絶之言出也下無廢上之義得絶之者明母得廢之臣下得從母命
魯子曰是王也不能乎母者其諸此之謂與	猶曰是王也無絶義不能事母而見絶外者其諸謂此灼然異居不復供養者與主書者録王者所居也○與音餘復扶又反供養九用反下餘亮反
〇晉侯夷吾卒	篡故不書葬明當絶也不日月者失衆身死子見篡逐故略之猶薛伯定也
二十有五年春王正月丙午衛侯燬滅邢衛侯燬何以名	据楚子滅蕭不名○燬況委反
絶曷爲絶之	据俱滅人
滅同姓也	絶先祖支體尤重故名甚之也日者爲魯憂内録之○爲魯于僞反下同
〇夏四月癸酉衛侯燬卒〇宋蕩伯姬來逆婦宋蕩伯姬者何蕩氏之母也	蕩氏宋丗大夫
其言來逆婦何	据莒慶言逆叔姬連來者嫌内女爲殺直來也
兄弟辭也其稱婦何有姑之辭也	宋魯之間名結㛰姻爲兄弟稱婦者見姑之辭以逆實文知不殺直來也主書者無出道也〇見賢徧反
〇宋殺其大夫何以不名	据宋殺其大夫山名
宋三丗無大夫三丗内娶也	三丗謂慈父王臣處臼也内娶大夫女也言無大夫者禮不臣妻之父母國内皆臣無娶道故絶去大夫名正其義也外小惡正之者宋以内娶故公族以弱妃黨益彊威權下流政分三門卒生篡弑親親出奔疾其未故正其本〇去起吕反
〇秋楚人圍陳納頓子于頓何以不言遂	据楚子鄚人侵陳遂侵宋
兩之也	微者示别遂但别兩耳别之者惡國家不重民命一出兵爲兩事也納頓子書者前出奔當絶還入爲盗國當誅書楚納之與之同罪也主書者從楚納之頓子出奔不書者小國例也不見挈者故君不可見挈於臣○惡烏路反
葬衛文公	不月者滅同姓故奪臣子恩也
冬十有二月癸亥公㑹衛子莒慶盟于洮	莒無大夫書苢慶者尊敬壻之義也洮内地公與未踰年君大夫盟不别得意雖在外猶不致也○别彼列反
二十有六年春王正月已未公㑹莒子衛寗遬盟于向	〇遫音速向舒亮反
齊人侵我西鄙公追齊師至嶲弗及其言至嶲弗及何	据公追戎于濟西不言所至又不言弗及〇嶲户圭反又似兖反
侈也	侈猶大也大公能却彊齊之兵弗者不之深者也言齊人畏公士卒精猛引師而去之深逺不可得及故曰侈不直言大之者自爲追唯臣子得襃之耳不得與追戎同也言師者侈大公所追也國内兵不書而斈地者善公齊師去則止不逺勞百姓過復取勝得用兵之節故録詳之〇侈昌爾反又昌者反大也卒子忽反自爲于僞反下深爲同
夏齊人伐我北鄙○衛人伐齊○公子遂如楚乞師乞者何卑辭也曷爲以外内同若辭	据春秋尊魯
重師也	外内皆同卑其辭者深爲與人者重之
曷爲重師	据泓之戰不重師
師出不正反戰不正勝也	不正者不正自謂出當復反戰當必勝兵凶器戰危事不得巳而用之爾乃以假人故重而不暇别外内也稱師者正所乞名也乞師例時〇當復扶又反下同别外彼列反下同
〇秋楚人滅隗以隗子歸	不月者略夷狄滅㣲國也不言獲者舉滅爲重書以歸者惡不死位不名者所傳聞丗見治始起責小國略但絶不誅之〇隗五罪反二傳作夔惡不烏路反下同傳直專反見治賢徧反下直吏反
〇冬楚人伐宋圍緍邑不言圍此其言圍何刺道用師也	時以師與魯未至又道用之於是惡其視百姓之命若草木不仁之甚也稱人者楚未有大夫未得稱師楚自道用之故從楚文
〇公以楚師伐齊取榖	言以者行公意别魯兵也稱師者順上文
公至自伐齊此巳取榖矣何以致伐	据伐邾婁取叢不致
未得乎取榖也	未可謂得意於取榖
曷爲未得乎取榖	据俱取邑
曰患之起必自此始也	魯内虚而外乞師以犯彊齊㑹齊侯昭卒晉文行霸幸而得免孔子曰人之生也直罔之生也幸而免故雖得意猶致伐也
二十七年春𣏌子來朝	貶稱子者起其無禮不備故魯入之
夏六月庚寅齊侯昭卒秋八月乙未葬齊孝公乙巳公子遂帥師入𣏌	日者𣏌屬脩禮朝魯雖無禮君子躬自厚而薄責於人不當乃入之故録責之○屬音燭
冬楚人陳侯蔡侯鄭伯許男圍宋此楚子也其稱人何	据序諸侯之上
貶曷爲貶	据圍鄭不貶
爲執宋公貶故終僖之篇貶也	古者諸侯有難王者若方伯和平之後相犯復故罪楚前執宋公僖公與共議釋之今復圍犯宋故貶因以見義終僖之篇貶者言君子知平人當終身保也〇爲于僞反難乃旦反今復扶又反見賢徧反
十有二月甲戍公㑹諸侯盟于宋	地以宋者起公解宋圍爲此盟也宋得與盟則宋解可知也而公釋之見矣〇與音預
二十有八年春晉侯侵曹晉侯伐衛曷爲再言晉侯	据楚人圍陳納頓子于頓亦兩事不再出楚人
非兩之也然則何以不言遂	据侵蔡遂伐楚言遂
未侵曹也未侵曹則其言侵曹何致其意也其意侵曹則曷爲伐衛晉侯將侵曹假塗于衛衛曰不可得則固將伐之也	曹有罪晉文行霸征之衛壅遏不得使義兵以時進故著言侵曹以致其意所以通賢者之心不使壅塞也宋襄公伐齊月此不月者晉文公功信未著且當脩文德未當深求於諸侯故不美也〇衛雍於勇反下同又作壅同遏於葛反
〇公子買戍衛不卒戍刺之不卒戍者何不卒戍者内辭也不可使往也	即往當言戍衛不卒
不可使往則其言戍衛何	据言戍衛行文
遂公意也	使臣子不可使恥深故諱使若往不卒竟事者明臣不得壅塞君命
刺之者何殺之也殺之則曷爲謂之刺之内諱殺大夫謂之刺之也	有罪無罪皆不得專殺故諱殺言刺之不言刺公子買但言不卒戍刺之者起爲上事刺之也内殺大夫例有罪不日無罪日外殺大夫皆時○起爲于僞反下爲下卒爲晉深爲不爲同
〇楚之救衛〇三月丙午晉侯入曹執曹伯卑宋人卑者何與也其言卑宋人何	据下執衛侯言歸之于京師〇卑宋必二反與也下同
與使聽之也	與使聽其獄也時天王居于鄭晉文欲討楚師以宋王者之後法度所存故因假使治之宋稱人者明聽訟必師斷與其師衆共之〇斷丁亂反下當斷同
曹伯之罪何甚惡也其甚惡奈何不可以一罪言也	曹伯數侵伐諸侯以自廣大傳曰晉侯執曹伯班其所取侵地于諸侯是也齊桓旣伇諸侯背叛無道者非一晉與曹同姓恩惠當先施刑罰當後加起而征之嫌其失義故著其甚惡者可知也以兵得不言獲者晉文伯討不坐獲者故亦不責曹不死義兵日者喜義兵得時入〇數所角反下數道同
○夏四月已巳晉侯齊師宋師秦師及楚人戰于城濮楚師敗績此大戰也曷爲使微者	据秦稱師録功知大戰必不使微者楚雖無大夫齊桓行霸書屈完也○濮音卜
子玉得臣也	以上敗績下殺得臣
子玉得臣則其稱人何	据屈完當桓公稱名氏
貶曷爲貶	据邲之戰林父不貶〇邲皮必反
大夫不敵君也	臣無敵君戰之義故絶正也秦稱師者助霸者征伐克勝有功故襃進之齊桓先朝天子晉文先討夷狄者晉文之時楚與爭彊所遭遇異
〇楚殺其大夫得臣	楚無大夫其言大夫者欲起上楚人本當言子玉得臣所以詳録霸事不氏者子玉得臣楚之驕蹇臣數道其君侵中國故貶明當與君俱治也〇道音導
〇衛侯出奔楚	晉文逐之不書逐之者以王事逐之擇立其次無絶衛之心惡不如出奔重
○五月癸丑公㑹晉侯齊侯宋公蔡侯鄭伯衛子莒子盟于踐土陳侯如㑹其言如㑹何	据曹伯襄言㑹諸侯
後㑹也	說與㑹伐宋同刺陳侯不慕霸者反歧意于楚失信後㑹㑹不致者安信與晉文也盟日者譎也衛稱子者起叔武本無即位之意陳歧意于楚在二十七年○譎古穴反
〇公朝于王所曷爲不言公如京師	据三月公如京師
天子在是也天子在是則曷爲不言天子在是	据狩于河陽
不與致天子也	時晉文公年老恐霸功不成故土白天子曰諸侯不可卒致願王居踐土下謂諸侯曰天子在是不可不朝迫使正君臣明王法雖非正起時可與故書朝因正其義不書諸侯朝者外小惡不書獨録内也不書如不言天王者從外正君臣所以見文公之功〇卒七忽反下倉卒同見賢徧反下不見當見見其同
○六月衛侯鄭自楚復歸于衛	言復歸者天子有命歸之名者刺天子歸有罪也言自楚者爲天子之諱也天子所以陵遲者爲善不賞爲惡不誅衛侯出奔當絶叔武讓國不當復廢而反衛侯令殺叔武故使若從楚歸者復歸例皆時此月者爲下卒出也〇當復扶又反令力呈反下令自同
〇衛元咺出奔晉	○咺況阮反
〇陳侯𣢾卒	不書葬者爲晉文諱行霸不務教人以孝陳有大喪而彊㑹其孤故深爲恥之宋襄亦背殯獨不爲齊桓諱者時宋襄自㑹之卒不日者賤其歧意于楚
○秋𣏌伯姬來〇公子遂如齊○冬公㑹晉侯齊侯宋公蔡侯鄭伯陳子莒子邾婁子秦人于温〇天王狩于河陽狩不書此何以書	据常事也
不與再致天子也	一失禮尚愈再失禮重故深正其義使若天子自狩非致也
魯子曰温近而踐土逺也	此魯子一說也温近狩地故可言狩踐土逺狩地故不言狩也公以再朝而日言之上說是
○壬申公朝于王所其日何	据上朝不日
録乎内也	危録内再失禮將爲有義者所惡不月而日者自是諸侯不繫天子若日不繫於月〇惡烏路反下惡衛同
○晉人執衛侯歸之于京師歸之于者何歸于者何歸之于者罪巳定矣歸于者罪未定也罪未定則何以得爲伯討	此難成公十五年晉侯執曹伯歸于京師〇難乃旦反下方難同
歸之于者執之于天子之側者也罪定不定巳可知矣	歸之者決絶之辭執于天子之側巳白天子罪定不定自在天子故言巳可知
歸于者非執之于天子之側者也罪定不定未可知也	未得白天子分别之者但欲明諸侯尊貴不得自相治當斷之于天子爾大惡雖未可知執有罪當爲伯討矣無罪而執人當貶稱人〇别彼列反
衛侯之罪何殺叔武也何以不書	据殺大夫書
爲叔武諱也春秋爲賢者諱何賢乎叔武	据失兄意〇爲叔于僞反下爲賢爲叔武及注而爲深爲皆同
讓國也其讓國奈何文公逐衛侯而立叔武叔武辭立而他人立則恐衛侯之不得反也故於是己立	故上稱子
然後爲踐土之㑹治反衛侯	叔武訟治於晉文公令白王者反衛侯使還國也叔武讓國見殺而爲叔武諱殺者明叔武治反衛侯欲兄饗國故爲去殺己之罪所以起其功而重衛侯之無道〇爲去起呂反
衛侯得反曰叔武篡我元咺爭之曰叔武無罪終殺叔武元咺走而出此晉侯也其稱人何	此以伯討而何貶者言歸之于伯討明知坐他事故更問之〇篡初患反
貶曷爲貶	据他罪不見
衛之禍文公爲之也文公爲之奈何文公逐衛侯而立叔武使人兄弟相疑	春秋許人臣者必使臣許人子者必使子文公惡衛侯大深愛叔武大甚故使兄弟相疑〇大深音泰下同
放乎殺母弟者文公爲之也	文公本逐之非故致此禍也逐之文不見故貶主書者以起文公逐之〇放乎甫往反
〇衛元咺自晉復歸于衛自者何有力焉者也	有力焉者有力于晉也言恃晉有屬己力以歸方難下意故於是發問〇屬音燭
此執其君其言自何	上元咺出奔晉而文公執衛侯知以元咺訴執之怪訴其君而助之
爲叔武爭也	解文公助之意以元咺爲叔武爭訴以爲忠於巳而助之雖然臣無訴君之義復於衛非也悖君臣之義故著言自明不當有力於惡人也言復歸者深爲霸者恥之使若無罪〇爭爭鬪之爭下注同悖必内反
〇諸侯遂圍許〇曹伯襄復歸于曹〇遂㑹諸侯圍許	曹伯言復歸者天子歸之也名者與衛侯鄭同義執歸不書書者名惡當見本無事不當言遂又不更舉曹伯者見其能悔過即時從霸者征伐也霸兵不月者刺文公不偃武脩文以附䟽倉卒飲服許卒不能降威信自是衰故不成其善〇降户江反
二十有九年春介葛盧來介葛盧者何夷狄之君也何以不言朝	据諸侯來曰朝○介葛音戒國名
不能乎朝也	不能升降揖讓也介者國也葛盧者名也進稱名者能慕中國朝賢君明當扶勉以禮義
○公至自圍許○夏六月公㑹王人晉人宋人齊人陳人蔡人秦人盟于狄泉	文公圍許不能服自知威信不行故復上假王人以㑹諸侯年老志衰不能自致故諸侯亦使微者㑹之月者惡霸功之廢於是○故復扶又反年末同惡烏路反
〇秋大雨雹	夫人專愛之所生〇兩于付反雹歩角反
〇冬介葛盧來	前公圍許不在故更來朝不稱字者一年再朝不中禮故不復進也〇中丁仲反
三十年春王正月〇夏狄侵齊〇秋衛殺其大夫元咺及公子瑕衛侯未至其稱國以殺何	据歸在下
道殺也	時巳得天子命還國於道路遇而殺之坐之與至國同故但稱國不復别也言及公子瑕者下大夫别尊卑○復扶又反别尊彼列反
〇衛侯鄭歸于衛此殺其大夫其言歸何	据未至而有專殺之惡與入惡同
歸惡乎元咺也	衛侯歸殺無惡則元咺之惡明矣
曷爲歸惡乎元咺	据師還
元咺之事君也君出則已入	意人執衛侯歸之于京師元咺自晉復歸于衛恃晉力以歸是也
君入則己出	衛侯鄭自楚復歸于衛元咺出奔晉是也
以爲不臣也	故不從犯伯執爲天子所還言復歸從出入無惡言歸以見元咺有出入罪衛侯得殺之所以專臣事君之義名者爲殺叔武惡天子歸有罪也執歸不書主書者名惡當見〇以見賢徧反下同爲于僞反惡夫烏路反
〇晉人秦人圍鄭〇介人侵蕭	稱人者侵中國故退之
〇冬天王使宰周公來聘	與葵丘㑹同義
〇公子遂如京師遂如晉大夫無遂事此何以禮四卜何以非禮	据俱卜也
求吉之道三	三卜吉凶必有相竒者可以決疑故求吉必三卜〇竒居宜反
禘甞不卜郊何以卜	禘比祫爲大甞比四時祭爲大故据之
卜郊非禮也	禮天子不卜郊
卜郊何以非禮	据上言三卜禮
魯郊非禮也	以魯郊非禮故卜爾昔武王旣没成王㓜少周公居攝行天子事制禮作樂致大平有王功周公薨成王以王禮葬之命魯使郊以彰周公之德非正故卜三卜吉則用之不吉則免牲謂之郊者天人相與交接之意也不言郊天者謙不敢斥尊〇少詩照反大平音泰王功于況反
魯郊何以非禮	据成公乃不郊惡之〇惡之烏路反下皆同
天子祭天	郊者所以祭天也天子所祭莫重於郊居南郊者就陽位也槀席玄酒器用陶匏大珪不瑑大羹不和爲天至尊物不可悉備故推質以事之○槀古老反匏白交反瑑大轉反和户卧反爲天于僞反下則爲本爲主爲皆同
諸侯祭土	土謂社也諸侯所祭莫重於社卿大夫祭五祀士祭其先祖
天子有方望之事	方望謂郊時所望祭四方羣神日月星辰風伯雨師五嶽四瀆及餘山川凡三十六所
無所不通	盡八極之内天之所覆地之所載無所不至故得郊也
諸侯山川有不在其封内者則不祭也	故魯郊非禮也
曷爲或言免牲或言免牛免牲禮也	魯卜郊不吉免之禮卜郊不吉則爲牲作玄衣纁裳使有司玄端放之於南郊明本爲天不敢留天牲
免牛非禮也免牛何以非禮傷者曰牛	養牲不謹敬有災傷天不饗用不得復爲天牲故以本牛名之非禮者非天牲不當復見免但當内自省責而巳〇復爲扶又反下同見免賢徧反下以見同
三望者何望祭也然則曷祭祭泰山河海曷爲祭泰山河海	据郊者主爲祭天〇大山音泰本亦作泰下同
山川有能潤于百里者天子秩而祭之	此皆助天宣氣布功故祭天及之秩者隨其大小尊卑髙下所宜禮祭天牲角繭栗社稷宗廟角握六宗五嶽四瀆角尺其餘山川視卿大夫天燎地瘞日月星辰布山縣水沉風磔雨升燎者取爼上七體與其珪寳在辨中置於柴上燒之〇繭古典反燎力召反瘞於例反縣音玄磔陟百反
觸石而岀膚寸而合	側手爲膚按指爲寸言其觸石理而出無有膚寸而不合〇膚寸方于反側手爲膚按指爲寸
不崇朝而徧雨乎天下者唯泰山爾	崇重也不重朝言一朝也〇崇朝如字注同雨于付反又如字崇重直龍反下同
河海潤于千里	亦能通氣致雨潤澤及于千里韓詩傳曰湯時大旱使人禱于山川是也郊望非一獨祭二者魯郊非禮故獨祭其大者
猶者何通可以巳也	巳止
何以書譏不郊而望祭也	譏尊者不食而卑者獨食書者惡失禮也魯至是郊者僖公賢君欲尊明其先祖之功德不就廢之譏者春秋不見事不書皆從事舉可知也不吉言不從者明己意汲汲欲郊而卜不從爾所以見事鬼神當加精誠
〇秋七月〇冬𣏌伯姬來求婦其言來求婦何兄弟辭也其稱婦何有姑之辭也	書者無出道也
〇狄圍衛〇十有二月衛遷于帝丘	月者惡大國遷至小國城郭堅固人衆彊遷徙畏人故惡之也
三十有二年春王正月○夏四月己丑鄭伯接卒	不書葬者殺大夫申侯也君殺大夫皆就葬别有罪無罪唯内無貶公之道不可去葬故從殺時别之○接二傳作捷别有彼列反下同去起吕反
○衛人侵狄○秋衛人及狄盟	不地者起因上侵就狄盟也復出衛人者嫌與内微者同也言及者時出不得狄君也稱人而言及則知狄盟者卑○復扶又反
〇冬十有二月己卯晉侯重耳卒	○重直龍反
三十有三年春王二月秦人入滑○齊侯使國歸父來聘○夏四月辛巳晉人及姜戎敗秦于殽其謂之秦何	据敗者稱師未得師稱人○殽本又作肴户爻反或户髙反
夷狄之也曷爲夷狄之	据俱見敗
秦伯將襲鄭	輕行疾至不戒以入曰襲〇輕遣政反
百里子與蹇叔子諫曰千里而襲人未有不亡者也	行疾不假塗變必生道逺多險阻遭變必亡○蹇居輦反
秦伯怒曰若爾之年者宰上之木拱矣	宰冢也拱可以手對抱〇拱九勇反以手對抱
爾曷知師出百里子與蹇叔子送其子而戒之曰爾即死必於殽之嶔巖是文王之所辟風雨者也	其處險阻隘勢一人可要百故文王過之驅馳常若辟風雨襲鄭所當由也○嶔苦銜反鄒湥生褚詮之音上林賦並同徐音欽韋昭漢書音義去瞻反又本或作廞同巖五銜反韋音嚴處昌慮反隘於賣反要一遥反傳要之同
吾將尸爾焉	在牀曰尸在棺曰柩
子揖師而行	揖其父於師中介胄不拜爲其拜如蹲〇胄直又反爲于僞反蹲音存
百里子與蹇叔子從其子而哭之秦伯怒曰爾曷爲哭吾師對曰臣非敢哭君師哭臣之子也	言恐臣先死子不見臣故先哭之
弦髙者鄭商也	鄭商賈人〇賈音古
遇之殽矯以鄭伯之命而犒師焉	詐稱曰矯犒勞也見其軍行非常不似君子恐見虜掠故生意矯君命勞之○矯以居表反犒苦報反勞也勞力報反下同掠音亮
或曰往矣或曰反矣	軍中語也時以爲鄭實使弦髙犒之或以爲鄭伯巳知將見襲必設備不如還或曰緒出當遂往之
然而晉人與姜戎要之殽而擊之匹馬隻輪無反者	然然上議猶豫留住之頃也匹馬一馬也隻踦也皆喻盡〇隻輪如字一本又作易輪董仲舒云車皆不還故不得易輪轍隻踦居宜反一本作易踦
其言及姜戎何	据秦人白狄不言及呉子主㑹也
姜戎微也	故絶言及
稱人亦微者也何言乎姜戎之微	据邢人狄人伐衛不言及
先軫也	先軫晉大夫也言姜戎微則知稱人者尊
或曰襄公親之	以旣貶又危文公葬
襄公親之則其稱人何	据桓十三年衛侯背殯用兵不稱人
貶曷爲貶	据俱背殯用兵
君在乎殯而用師危不得葬也	與衛迫齊宋異故惡不子也〇惡不烏路反下同
詐戰不日此何以日	据不言敗績外詐戰文也詐卒也齊人語也〇卒七忽反
盡也	惡晉不仁
〇癸巳葬晉文公〇狄侵齊○公伐邾婁取叢	取邑不致者得意可知例〇取菆才工反二傳作取訾樓
〇秋公子遂率師伐邾婁○晉人敗狄于箕	不月者略微者與夷狄也
〇冬十月公如齊	月者善公念齊恩及子孫
〇十有二月公至自齊○乙巳公薨于小寢〇霣霜不殺草	○霣于敏反
李梅實何以書記異也何異爾不時也	周之十二月夏之十月也易中孚記曰隂假陽威之應也早霣霜而不殺萬物至當霣霜之時根生之物復榮不死斯陽假與隂威隂威列索故陽自霣霜而反不能殺也此禄去公室政在公子遂之應也〇復扶又反索息各反
〇晉人陳人鄭人伐許春秋公羊卷第五	經傳㭍阡壹伯丹叄字注壹萬玖伯叄拾字音義貳阡參伯壹拾陸字
