春秋經傳集解成上第十二	陸云成公名黑肱宣公子謚法安民立政曰成
杜氏盡十年經元年春王正月公即位	無傳
〇二月辛酉葬我君宣氷	無傳周二月仐之十二月而無氷書冬温
〇三月作丘甲	周禮九夫爲井四井焉邑四邑爲正丘十六井出戎馬一匹牛三頭四丘爲甸甸六十四井出長轂一乗戎馬四匹牛十二頭甲士三人歩卒七十二人此甸所賦今魯使丘出之譏重斂故書甸徒練切又繩證切乗繩證切卒尊忽切斂力驗切
〇夏臧孫許及晉侯盟于赤棘	晉地
〇秋王師敗績子茅戎	茅戎戎别也不言戰王者至尊天下莫之得校故以自敗爲文不書敗地而書茅戎明爲茅戎所敗書秋從告茅戎亡交切史記及二傳皆作買式種章勇切
〇冬十月傳元年春晉侯使瑕嘉平戎于王	平文十七年邥垂之役詹嘉處瑕故謂之瑕嘉邥音審詹之廉切
單襄公如晉拜成	單襄公王卿士謝晉爲平戎單音善爲于僞切下文同
劉康公徼戎將遂伐之	康公王季子也戎平還欲要其無備徼古堯切要也要一遥切
叔服曰背盟而欺大國此必敗	叔服周内史背音佩下同
背盟不祥欺大國不義神人弗助將何以勝不聽遂伐茅戎三月癸未敗績于徐吾氏	徐吾氏茅戎之别也
〇爲齊難故作丘甲	前年魯乞師於楚欲以伐齊楚師不出故懼而作丘甲難乃旦切下同
〇聞齊將出楚師夏盟于赤棘	與晉盟懼齊楚
〇秋王人來告敗	解經所以秋乃書
〇冬臧宣叔令脩賦繕完	治完城郭繕市戰切完和端切
具守備曰齊楚結好我新與晉盟晉楚爭盟齊師必至雖晉人伐齊楚必救之是齊楚同我也	同共也守手又切好呼報切
知難而有備乃可以逞	逞解也爲二年齊侯伐我傳解音蟹
經二年春齊侯伐我北鄙〇夏四月丙戍衛孫良夫帥師及齊師戰于新築衛師敗績	新築衛地皆陳曰戰大崩曰敗績四月無丙戌丙成王月一日築音竹陳直覲切
○六月癸酉季孫行父臧孫許叔孫僑如公孫嬰齊帥師㑹晉郤克衛孫良夫曹公子首及齊侯戰干鞌齊師敗績	魯乞師於晉而不以與謀之例者從盟主之令上行於下非匹敵和成之類例在宣七年曹大夫常不書而書公子首者首命於國備於禮成爲卿故也鞌齊地僑其僑切郤去逆切鞌音安與音預敵如字一本或作適亦音敵
〇秋七月齊侯使國佐如師已酉及國佐盟于袁婁	榖梁曰鞌去齊五百里袁婁去齊五十里
〇八月壬午宋公鮑卒	未同盟而赴以名鮑歩卯切
〇庚寅衛侯速卒	宣十七年盟于斷道據傳庚寅九月七日
〇取汶陽田	晉使齊還魯故書取不以好得故不言歸汶音問好呼報切
〇冬楚師鄭師侵衛	子重不書不親代
〇十有一月公㑹楚公子嬰齊于蜀	公與大夫㑹不貶嬰齊者時有許蔡之君故
〇丙申公及楚人秦人宋人陳人衛人鄭人齊人曹人邾人薛人鄫人盟于蜀	齊在鄭下非卿傳曰卿不書匱盟也然則楚卿於是始與中國凖自此以下楚卿不書皆貶惡也匱其位切
傳二年春齊侯伐我北鄙圍龍	龍魯邑在泰山博縣西南
頃公之嬖人盧蒲就魁門焉	攻龍門也頃音傾嬰必計切魁苦囬切
龍人囚之齊侯曰勿殺吾與而盟無入而封	封竟竟音境
弗聽殺而膊諸城上	膊磔也膊普各切磔陟百切
齊侯親鼓士陵城三日取龍遂南侵及巢丘	取龍侵巢丘不書其義未聞
衛侯使孫良夫石稷寗相向禽將侵齊與齊師遇	齊伐魯還相遇於衛地良夫孫林父之父石稷石碏四世孫寗相寗俞子相息亮切向舒亮切碏七略切俞羊朱切
石子欲還孫子曰不可以師伐人遇其師而還將謂君何	言無以荅君
若知不能則如無出仐旣遇矣不如戰也夏有	闕文失新築戰事
石成子曰師敗矣子不少須衆懼盡	成子石稷也衛師巳敗而孫良夫復欲戰故成子欲使須救復扶又切
子喪師徒何以復命皆不對又曰子國卿也隕子辱矣	隕見禽獲喪息浪切隕干敏切
子以衆退我此乃止	我於此止禦齊師禦魚吕切
且告車來甚衆	新築人救孫桓子故並告令軍中
齊師乃止次于鞫居	鞫居衛地鞫居六切
新築人仲叔于奚救孫桓子桓子是以免	于奚守新築大夫
旣衛人賞之以邑	賞于奚
辭請曲縣	軒縣也周禮天子樂宫縣四周諸侯軒縣闕南方縣音玄注同
繁纓以朝許之	繁纓馬飾皆諸侯之服繁歩干切注同
仲尼聞之曰惜也不如多與之邑唯器與名不可以假人	器車服名爵號
君之所司也名以出信	名位不愆爲民所信愆起䖍切
信以守器	動不失信則車服可保
器以藏禮	車服所以表尊卑
禮以行義	尊卑有禮各得其冝
義以生利	得其冝則利生
利以平民政之大節也若以假人與人政也政亡則國家從之弗可止也巳孫桓子還於新築不入	不入國
遂如晉乞師臧宣叔亦如晉乞師皆主郤獻子	宣十七年郤克至齊爲婦人所笑遂怒故魯衛因之孫桓子臧宣叔皆不以國命各自詣卻克故不書
晉侯許之七百乗	五萬二千五百人乘繩證切下同
郤子曰此城濮之賦也	城濮在僖二十八年濮音卜
有先君之明與先大夫之肅故捷克於先大夫無能爲役	不中爲之役使
請八百乗許之	六萬人
郤克將中軍士爕佐上軍	苑文子代荀庚將子匠切
欒書將下軍	代趙朔
韓厥爲司馬以救魯衛臧宣叔逆晉師且道之季文子帥師㑹之及衛地韓獻子將斬人郤獻子馳將救之至則旣斬之矣郤子使速以徇告其僕曰吾以分謗也	不欲使韓氏獨受謗道音導徇似俊切
師從齊師于莘	莘齊地莘所巾切
六月壬申師至于靡笄之下	靡笄孔名靡如字又音摩笄音雞
齊侯使請戰曰子以君師辱於敝邑不腆敝賦詰朝請見	詰朝平旦腆他典切詰起吉切朝如字注及下朝夕朝食同見賢遍切
對曰晉與魯衛兄弟也來告曰大國朝夕釋憾於敝邑之地	大國謂齊敝邑魯衛自稱憾胡暗切本又作感
寡君不忍使羣臣請於大國無令輿師淹於君地	輿衆也淹久也令力呈切帥如字下無令輿師同一音所類切
能進不能退君無所辱命	言自欲戰不復須君命復扶又切
齊侯曰大夫之許寡人之願也若其不許亦將見也齊髙固入晉師桀石以投人	桀擔也擔丁甘切
禽之而乗其車	旣獲其人因釋已車而載所獲者車
繫桑本焉以徇齊壘	將至齊壘以桑樹繫車而走欲自異壘力軌切
曰欲勇者賈余餘勇	賈買也言已勇有餘欲賣之賈音古注同賣摩懈切
癸酉師陳于鞌邴夏御齊侯逢丑父爲右晉解張御郤克鄭丘緩爲右齊侯曰余姑翦滅此而朝食	姑且也翦盡也陳直覲切邴音丙又彼命切夏戸雅切解音蟹張如字又直亮切
不介馬而馳之	介甲也
郤克傷於矢流血及屨未絶鼔音	中軍將自執旗鼔故雖傷而擊鼓不息將子匠切下將在左同
曰余病矣張侯曰自始合而矢貫余手及肘余折以御左輪朱殷豈敢言病吾子忍之	張侯解張也朱血色血色乆則殷殷音近烟今人謂赤黒爲殷色言血多汚車輪御猶不敢息貫直亂切下注同肘竹九切折之設切殷於閑切徐於辰切注同近附近之近污汗穢之汗字林一故切
緩曰自始合苟有儉余必下推車子豈識之然子病矣	以其不識巳推車推昌誰切又他囬切注及下推車同
張侯曰師之耳目在吾旗鼓進退從之此車一人殿之可以集事	殿鎭也集成也殿多練切住同
若之何其以病	陸云絶旬
敗君之大事也擐甲執兵固即死也	擐貫也即就也擐音患
病未及死吾子勉之左并轡右援枹而鼔馬逸不能止師從之	晉師從郤克軍并必政切徐方聘切援音爰枹音浮鼔槌也字林云擊鼔柄也本亦作桴
齊師敗績遂之三周華不注	華不注山名華如字又户化切注之住切
韓厥夢子輿謂已曰且辟左右	子與韓厥父
故中御而從齊侯	居中代御者自非元帥御者皆在中將在左帥所類切
邴夏曰射其御者君子也公曰謂之君子而射之非禮也	齊侯不知戎禮射食亦切下并注皆同
射其左越于車下	越隊也隊宜類切
射其右斃于車中綦母張喪車從韓厥曰請寓乗	綦母張晉大夫寓寄也綦音其母音無喪息浪切乘繩證切
從左右皆射之使立於後	以左右皆死不欲使立其處處昌慮切
韓厥俛定其右	俛俯也右被射仆車中故俯安隱之俛音勉仆音赴又蒲比切
逢丑父與公易位	居公處
將及華泉絓於木而止	驂馬絓也華戸化切絓戸卦切一音卦驂七南切
丑父寢於轏中	轏士車轏仕産切又仕板切字林仕諫切云卧車也
蛇出於其下以肱擊之傷而匿之故不能推車而及	爲韓厥所及丑父欲爲右故匿其傷肱古弘切匿女力切注同
韓厥執縶馬前	縶馬絆也執之示脩臣僕之職縶張立切絆音半
再拜稽首奉觴加璧以進	進觴璧亦以示敬觴式羊切
曰寡君使羣臣爲魯衛請曰無令輿師陷入君地	本但爲二國救請不欲乃過入君地謙辭爲于僞切注同令力呈切
下臣不幸屬當戎行無所逃隱	屬適屬音燭注同行下郎切
且懼奔辟而忝兩君臣辱戎士	若奔辟則爲辱晉君并爲齊侯羞故言二君此蓋韓厥目處臣僕謙敬之飾言辟音避注同徐扶臂切服氏扶赤切
敢告不敏攝官承乏	言欲以己不敏攝承空乏從君俱還從才用切义如字
丑父使公下如華泉取飲鄭周父御佐車宛茷爲右載齊侯以免	佐車副車宛紆元切茷扶廢切
韓厥獻丑父郤獻子將戮之呼曰自今無有代其君任患者有一於此將爲戮乎郤子曰人不難以死免其君我戮之不祥赦之以勸事君者乃免之齊侯免求丑父三入三出	重其代已故三入晉軍求之呼火故切任音壬難乃旦切
每出齊師以帥退入于狄卒	齊師大敗皆有退心故齊侯輕出其衆以帥厲退者遂迸入狄卒狄卒者狄人從晉討齊者卒子忽切注同輕遺政切迸補諍切
狄卒皆抽戈楯冒之以入于衛師衛師免之	狄衛畏齊之彊故不敢害齊侯皆共免護之楯食凖切又音允冒亡報切
遂自徐關入齊侯見保者曰勉之齊師敗矣	所過城邑皆勉勵其守者
辟女子	使辟君也齊侯單還故婦人不辟之辟音避注下同一音扶亦切單音丹
女子曰君免乎曰免矣曰銳司徒免乎曰免矣	銳司徒主銳兵者銳恱歳切
曰茍君與吾父免矣可若何	言餘人不可復如何復扶又切
乃奔	走辟君
齊侯以爲有禮	先問君後問父故也
旣而問之辟司徒之妻也	辟司徒主壘壁者辟音壁必覓切注同徐甫亦切
予之石窌	石窌邑名濟北盧孫東有地名石窌窌力救切一音力到切
晉師從齊師入自丘輿擊馬陘	丘輿馬陘皆齊邑陘音刑
齊侯使賔媚人賂以紀甗玉磬與地	媚人國佐也甗玉甑皆滅紀所得媚美冀切賂音路甗魚輦切徐音彦又音言字林牛徤切甑子孕切又慈陵切
不可則聽客之所爲賔媚人致賂晉人不可曰必以蕭同叔子爲質	同叔蕭君之字齊侯外祖父子女也難斥言其母故逺言之質徐音致下同難乃旦切
而使齊之封内盡東其畝	使壟畝東西行盡津忍切壟力勇切行户郎切又如字
對曰蕭同叔子非他寡君之母也若以匹敵則亦晉君之母也吾子布大命於諸侯而曰必質其母以爲信其若王命何	言違王命
且是以不孝令也詩曰孝子不匱永錫爾類	詩大雅言孝心不乏者又能以孝道長賜其志類
若以不孝今於諸侯其無乃非德類也乎	不以孝德賜同類
先王疆理天下物土之冝而布其利	疆界也理正也物土之冝播殖之物各從土冝疆居良切注下皆同
故詩曰我疆我理南東其畝	詩小雅或南或東從其土冝
今吾子疆理諸侯而曰盡東其畝而巳唯吾子戎車是利	晉之伐齊循壟東行易易以䜴切
無顧土冝其無乃非先王之命也乎反先王則不義何以爲盟主其晉實有闕	闕失
四王之王也	禹湯文武下王于況切
樹德而濟同欲焉	樹立也濟成也
五伯之霸也	夏伯昆吾商伯大彭豕韋周伯齊桓晉文釋文或曰齊桓晉文宋襄秦穆楚莊
勤而撫之以役王命	役事也
今吾子求合諸侯以逞無疆之欲	疆竟也竟如字又音境
詩曰布政優優百禄是遒	詩頌殷湯布政優和故百禄來聚遒聚也遒在由切徐子由切
子實不優而棄百禄諸侯何害焉	言不能爲諸侯害
不然	不見許
寡君之命使臣則有辭矣曰子以君師辱於敝邑不腆敝賦以犒從者	戰而曰犒爲孫辭使所吏切犒苦報切從才用切
畏君之震師徒橈敗	震動橈曲也橈刀敎切
吾子惠徼齊國之福不泯其社稷使繼舊好唯是先君之敝器土地不敢愛子又不許請收合餘燼	燼火餘木泯彌忍切好呼報切合如字一音閤燼似刃切
背城借一	欲於城下復借一戰背音佩復扶又切
敝邑之幸亦云從也況其不幸敢不唯命是聽	言完全之時尚不敢違晉今若不幸則從命
魯衛諫曰齊疾我矣	諫卻克也
其死亡者皆親暱也子若不許讎我必甚唯子則又何求子得其國寳	謂甗磬暱女乙切
我亦得地	齊歸所侵
而紓於難	齊服則難緩紓音舒緩也一音直吕切難乃旦切注同
其榮多矣齊晉亦唯天所授豈必晉晉人許之對曰羣臣帥賦輿	賦輿猶兵車
以爲魯衛請若苟有以藉口而復於寡君	藉薦復白也爲于僞切藉在夜切注同
君之惠也敢不唯命是聽禽鄭自師逆公	禽鄭魯大夫歸逆公㑹晉師
秋七月晉師及齊國佐盟于爰婁使齊人歸我汶陽之田公㑹晉師于上鄍	上鄍地闕公㑹晉師不書史闕鄍覓經切
賜三帥先路三命之服	三帥郤克士爕欒書巳甞受王先路之賜今改而易新并此車所建所服之物帥所類切注及下同
司馬司空輿帥候正亞旅皆受一命之服	晉司馬司空皆大夫輿帥主兵車候正主斥候亞旅亦大夫也皆魯侯賜
○八月宋文公卒始厚葬用蜃炭益車馬始用殉	燒蛤爲炭以瘞壙多埋車馬用人從葬蜃市忍切蛤也炭吐旦切殉似俊切蛤古荅切瘞於例切曠苦晃切一音曠
重器備	重猶多也重直恭切注同
椁有四阿棺有翰檜	四阿四注椁也翰旁飾檜上飾皆王禮椁音郭翰戸旦切一音韓檜古外切徐音㑹
君子謂華元樂舉於是乎不臣臣治煩去惑者也是以伏死而爭今二子者君生則縱其惑	謂文十八年殺母弟須去起吕切下去之同爭爭鬬之爭
死又益其侈是棄君於惡也何臣之爲	若言何用爲臣侈昌氏切又式氏切
〇九月衛穆公卒晉三子自役弔焉哭於大門之外	師還過衛故因弔之未復命故不敢成禮過古禾切又古卧切
衛人逆之	逆於門外設喪位
婦人哭於門内	喪位婦人哭於堂賔在門外故移在門内
送亦如之遂常以葬	至葬行此禮
〇楚之討陳夏氏也	在宣十一年夏戸雅切下同
莊王欲納夏姬申公巫臣曰不可君召諸侯以討罪也今納夏姬貪其色也貪色爲淫淫爲大罰周書曰明德愼罰	周書康誥
文王所以造周也明德務崇之之謂也愼罰務去之之謂也若興諸侯以取大罰非愼之也君其圖之王乃止子反欲取之巫臣曰是不祥人也是天子蠻	子蠻鄭靈公夏姬之兄殺死無後殺申志切下丈殺靈侯同
敎御叔	御叔夏姬之夫亦早死御魚據切
殺靈	子跪其委切一音居委切從才用切郢以井切又以政切
曰異哉夫子有三軍之懼而又有桑中之喜宜將竊妻以逃者也	桑中衛風淫奔之詩
及鄭使介反幣而以夏姬行	介副也幣聘物介音界
將奔齊齊師新敗曰吾不處不勝之國遂奔晉而因郤至	至郤克族子
以臣於晉晉人使爲邢大夫	邢晉邑邢音刑
子反請以重幣錮之	禁錮勿令仕錮音固令力呈切
王曰止其自爲謀也則過矣其爲吾先君謀也則忠忠社稷之固也所蓋多矣	蓋覆也上爲于僞切父如字下爲于僞切
且彼若能利國家雖重幣晉將可乎	言不許
若無益於晉晉將棄之何勞錮焉	爲七年楚滅巫臣族晉南通具張仁
〇晉師歸范文子後入武子曰無爲吾望爾也乎	武子士㑹文子之父
對曰師有功國人喜以逆之先入必屬耳目焉是代帥受名也故不敢武子曰吾知免矣	知其不益己禍屬章欲切後同帥所類切下注稱帥軍帥將帥同吾知一本無知字
郤伯見公曰子之力也夫對曰君之訓也二三子之力也臣何力之有焉	郤伯郤克見賢遍切下同夫音扶
范叔見勞之如郤伯對曰庚所命也克之制也爕何力之有焉	荀庚將上軍時不出范文子上軍佐代行故稱帥以讓勞力報切將子匠切下同
欒伯見公亦如之對曰爕之詔也士用命也書何力之有焉	詔告也欒書下軍帥故推功上軍傳言晉將帥克讓所以能勝齊
〇宣公使求好于楚莊王卒宣公薨不克作好	在宣十八年好呼報切下同
公即位受盟于晉	元年盟赤棘
㑹晉伐齊衛人不行使于楚	不聘楚使所吏切
而亦受盟于晉從於伐齊故楚令尹子重爲陽橋之役以救齊將起師子重曰君弱	傳曰寡人生十年而喪先君共王即位至是三年蓋年十二三矣
羣臣不如先大夫師衆而後可詩曰濟濟多士文王以寧	詩大雅言文王以衆士安濟子禮切
夫文王猶用衆況吾儕乎	儕等儕仕皆切
且先君莊王屬之曰無德以及逺方莫如惠恤其民而善用之乃大戸	閱民戸口閱音恱
巳責	棄逋責逋𥙷呉切
逮鰥	施及老鰥鰥古頑切施始豉切
救乏赦罪悉師王卒盡行彭名御戎蔡景公爲左許靈公爲右	王卒盡行故王戎車亦行雖無楚王令二君當左右之位卒子忽切注同令力呈切
二君弱皆強冠之冬楚師侵衛遂侵我師于蜀	公賂之而退故不書侵強其丈切冠古亂切
使臧孫往	臧孫宣叔也
辭曰楚逺而乆固將退矣無功而受名臣不敢	不敢虚受退楚名
楚侵及陽橋	陽橋魯地
孟孫請往賂之	楚侵遂深故孟孫請以賂往孟孫獻子也
以執斵執鍼織紝	執斵匠人執鍼女工織紝織繒布者斲竹角切鍼之林切紝女金切徐而鴆切
皆百人公衡爲質	公衡成公子質音致
以請盟楚人許平十一月公及楚公子嬰齊蔡侯許男秦右大夫說宋華元陳公孫寧衛孫良夫鄭公子去疾及齊國之大夫盟于蜀	齊大夫不書其名非卿也說音恱去起吕切
卿不書匱盟也於是乎畏晉而竊與楚盟故曰匱盟	匱乏也
蔡侯許男不書乗楚車也謂之失位	乗楚王車爲左右則失位也卿不書則稱人諸侯不書皆不見經君臣之别見賢遍切别彼列切
君子曰位其不可不愼也乎蔡許之君一失其位不得列於諸侯況其下乎詩曰不解于位民之攸墍	詩大雅言在上者勤正其位則國安而民息也悠所也墍息也解佳賣切墍許器切
其是之謂矣楚師及宋公衡逃歸臧宣叔曰衡父不忍數年之不宴	宴樂也數所主切樂音浴
以棄魯國國將若之何誰居後之人必有任是夫國棄矣	居辭也言後人必有當此患居音基任音壬夫音扶
是行也晉辟楚畏其衆也君子曰衆之不可以巳也大夫爲政猶以衆克況明君而善用其衆乎大誓所謂商兆民離周十人同者衆也	大誓周書萬億曰兆民離則弱合則成衆言殷以散亡周以衆興
〇晉侯使鞏朔獻齊捷于周王弗見使單襄公辭焉曰蠻夷戎狄不式王命	式用也捷在妾切
淫湎毀常王命伐之則有獻捷王親受而勞之所以懲不敬勸有功也兄弟甥舅侵敗王略	兄弟同姓國甥舅異姓國略經略法度湎面善切勞力報切敗必邁切
王命伐之告事而巳不獻其功所以敬親暱	告伐事而不獻囚俘暱女乙切
禁淫慝也	涇慝爲虣掠百姓取囚俘也慝他得切虣本又作暴薄報切掠音亮
今叔父克遂有功于齊	克能也
而不使命卿鎭撫王室所使來撫余一人而鞏伯實來未有職司於王室	鞏朔上軍大夫非命卿名位不達於王室
又奸先王之禮	謂獻齊捷奸音于
余雖欲於鞏伯	欲受其獻
其敢廢舊典以忝叔父夫齊甥勇之國也而大師之後也	齊世與周昏故曰甥舅大音泰
寧不亦淫從其欲以怒叔父抑豈不可諫誨士莊伯不能對	莊伯鞏朔從子用切本亦作縱
王使委於三吏	委屬也三吏三公也陸云天子之吏也
禮之如侯伯克敵使大夫告慶之禮降於卿禮一等王以鞏伯宴而私賄之使相告之曰非禮也勿籍	相相禮者籍書也王畏晉故私宴賄以慰鞏朔相息亮切注同
經三年春王正月公㑹晉侯宋公衛侯曹伯伐鄭	宋衛未葬而稱爵以接鄰國非禮也
〇辛亥葬衛穆公	無傳
○二月公至自伐鄭	無傳
〇甲子新宫災三日哭	無傳三年喪畢宣公神主新入廟故謂之新宫書三日哭善得禮宗廟親之神靈所馮居而遇災故哀而哭之馮皮氷切
〇乙亥葬宋文公	無傳七月而葬緩
○夏公如晉〇鄭公子去疾帥師伐許○公至自晉	無傳
〇秋叔孫僑如帥師圍棘	棘汶陽田之邑在濟北蛇丘縣蛇以支切一音如宇
〇大雩	無傳以過時書
〇晉郤克衛孫良夫伐廧咎如	赤狄别種廧在良切咎古刀切種章勇切
○冬十有一月晉侯使荀庚來聘〇衛侯使孫良夫來聘○丙午及荀庚盟〇丁未及孫良夫盟	先晉後衛尊霸主
〇鄭伐許	無傳不書將帥告辭略將子匠切帥所類切
傳三年春諸侯伐鄭次于伯牛討邲之役也	伯牛鄭地邲役在宣十二年
遂東侵鄭	晉潜軍深入
鄭公子偃帥師禦之	偃穆公子
使東鄙覆諸鄤	覆伏兵也覆扶又切注同鄤亡袁切又莫干切徐武旦切一音萬
敗諸丘輿	鄤丘輿皆鄭地晉偏軍爲鄭所敗故不書
皇戍如楚獻捷○夏公如晉拜汶陽之田	前年晉使齊歸魯汶陽田故
〇許恃楚而不事鄭鄭子良伐許○晉人歸公子榖臣與連尹襄老之尸于楚以求知罃	邲之戰楚獲知罃
於是荀首佐中軍矣	荀首知罃父
故楚人許之王送知罃曰子其怨我乎對曰二國治戎臣不才不勝其任以爲俘馘執事不以釁鼓	以血塗鼔爲釁鼔勝音升下注同俘芳夫切馘古獲切釁許覲切
使歸即戮君之惠也臣實不才又誰敢怨王曰然則德我乎對曰二國圖其社稷而求紓其民	紓緩也紓音舒
各懲其忿以相宥也	宥赦也懲直升切宥音又
兩釋纍囚以成其好	纍繁也纍力誰切好呼報切下同
二國有好臣不與及其誰敢德	言二國本不爲己與音預爲于僞切
王曰子歸何以報我對曰臣不任受怨君亦不任受德無怨無德不知所報王曰雖然必告不榖對曰以君之靈纍臣得歸骨於晉寡君之以爲戮死且不朽	戮其不勝任任音壬下亦不任同
若從君之惠而免之以賜君之外臣首	稱於異國君曰外臣
首其請於寡君而以戮於宗亦死且不朽若不獲命	君不許戮
而使嗣宗職	嗣其祖宗之位職
次及於事而帥偏師以脩封疆雖遇執事	遇楚將帥疆居良切
其弗敢違	違辟也
其竭力致死無有二心以盡臣禮所以報也王曰晉未可與爭重爲之禮而歸之○秋叔孫僑如圍棘取汶陽之田棘不服故圍之	僑如叔孫得臣子
○晉郤克衛孫良夫伐廧如討赤狄之餘焉	宣十五年晉滅赤狄潞氏其餘民散入廧咎如故咎之
廧咎如潰上失民也	此傳釋經之文而經無廧咎如潰蓋經闕此四字潰戸内切
〇冬十一月晉侯使荀庚來聘且㝷盟	㝷元年赤棘盟荀庚林父之子
衛侯使孫良夫來聘且㝷盟	㝷宣七年盟
公問諸臧宣叔曰仲行伯之於晉也其位在三	下卿
孫子之於衛也位爲上卿將誰先對曰次國之上卿當大國之中中當其下下當其上大夫	降一等
小國之上卿當大國之下卿中當其上大夫下當其下大夫	降大國二等
上下如是古之制也	古制公爲大國侯伯爲次國子男爲小國
衛在晉不得爲次國	春秋時以強弱爲大小故衛雖侯爵猶爲小國
晉爲盟主其將先之	計等則二人位敵以盟主故先晉
丙午盟晉丁未盟衛禮也〇十二月甲戍晉作六軍	爲六軍僣王也萬二千五百人爲軍僣子念切
韓厥趙括鞏朔韓穿荀騅趙旃皆爲卿賞鞌之功也	韓厥爲新中軍趙括佐之鞏朔爲新上軍韓穿佐之荀騅爲新下軍趙旃佐之晉舊自有三軍今増此故爲六軍騅音佳
〇齊侯朝于晉將授玉	行朝禮
郤克趨進曰此行也君爲婦人之笑辱也寡君未之敢任	言齊侯之來以謝婦人之笑非爲脩好故云晉君不任當此惠爲于僞切及下爲兩君同任音壬
晉侯享齊侯齊侯視韓厥韓厥曰君知厥也乎齊侯曰服改矣	戎朝異服也言服改明識其人
韓厥登舉爵曰臣之不敢愛死爲兩君之在此堂也〇荀罃之在楚也鄭賈人有將寘諸禇中以出旣謀之未行而楚人歸之賈人如晉荀罃善視之如實出己賈人曰吾無其功敢有其實乎吾小人不可以厚誣君子遂適齊	傳言知罃之賢賈音古下同寘之䜴切褚中吕切
經四年春宋公使華元來聘〇三月壬申鄭伯堅卒	無傳二年大夫盟于蜀壬申二月二十八日
〇𣏌伯來朝〇夏四月甲寅臧孫許卒	無傳
〇公如晉〇葬鄭襄公	無傳
〇秋公至自晉〇冬城鄆	無傳公欲叛晉故城而爲備鄆音運
〇鄭伯伐許傳四年春宋華元來聘通嗣君也	宋共公即位共音恭
〇𣏌伯來朝歸叔姬故也	將出叔姬先脩禮朝魯言其故
〇夏公如晉晉侯見公不敬季文子曰晉侯必不免	言將不能壽終也後十年陷厠而死
詩曰敬之敬之天惟顯思命不易哉	詩頌言天道顯明受其命甚難不可不敬以奉之易以䜴切
夫晉侯之命在諸侯矣可不敬乎	敬諸侯則得天命
秋公至自晉欲求成于楚而叛晉季文子曰不可晉雖無道未可叛也國大臣睦而邇於我	邇近也
諸侯聽焉未可以貳	聽服也
史佚之志有之	周文王大史大音泰
曰非我族類其心必異楚雖大非吾族也	與魯異姓
其肯字我乎公乃止	字愛也
〇冬十一月鄭公孫申帥師疆許田	前年鄭伐許侵其田今正其界疆居良切
許人敗諸展陂鄭伯伐許取鉏任泠敦之田	展陂亦許地陂彼皮切鉏仕居切任音壬泠力丁切
晉欒書將中軍	代郤克將子匠切
荀首佐之士爕佐上軍以救許伐鄭取汜祭	汜祭鄭地成皐縣東有汜水汜音凡注同或音祀祭側介切
楚子反救鄭鄭伯與許男訟焉	於子反前爭曲直
皇戍攝鄭伯之辭	代之對
子反不能決也曰君若辱在寡君寡君與其二三臣共聽兩君之所欲成其可知也	欲使自屈在楚子前決之
不然側不足以知二國之成	側子反名爲明年許愬鄭於楚張本愬音素
○晉趙嬰通于趙莊姬	趙嬰趙盾弟莊姬趙朔妻朔盾之子
經五年春王正月𣏌叔姬來歸	出也傳在前年
〇仲孫蔑如宋〇夏叔孫僑如㑹晉荀首于榖	榖齊地
〇梁山崩	記異也梁山在馮翊夏陽縣北
〇秋大水	無傳
〇冬十有一月已酉天王崩〇十有二月已丑公㑹晉侯齊侯宋公衛侯鄭伯曹伯邾子杞伯同盟于蟲牢	蟲牢鄭地陳留封丘縣北有桐牢
傳五年春原屏放諸齊	放趙嬰也原同屏季嬰之兄屏歩丁切
嬰曰我在故欒氏不作我云吾二昆其憂哉且人各有能有不能	言己雖淫而能今莊姬護趙氏令力丁切
舎我何害弗聽嬰夢天使謂己祭余余福女使問諸士貞伯貞伯曰不識也旣而告其人	自告貞伯從人舎音捨又音赦聽吐丁切女音汝従才用切
曰神福仁而禍淫淫而無罰福也祭其得亡乎	以得放遣爲福
祭之之明日而亡	爲八年晉殺趙同趙括傳
〇孟獻子如宋報華元也	前年宋華元來聘
〇夏晉荀首如齊逆女故宣伯餫諸榖	野饋曰餫運糧饋之敬大國也餫音鄆饋其媿切
〇梁山崩晉侯以傳召伯宗	傳驛傳中戀切注及下同驛音亦
伯宗辟重曰辟傳	重載之車上辟匹亦切徐甫赤切本又作僻下辟音避
重人曰待我不如捷之速也	捷邪出捷在妾切邪似嗟切
問其所曰絳人也問絳事焉曰梁山崩將召伯宗謀之問將若之何曰山有朽壤而崩可若何國主山川	主謂所主祭絳古巷切壤如大切
故山崩川竭君爲之不舉	去盛饌爲于僞切去起吕切饌仕戀切
降服	損盛服
乗縵	車無文縵武旦切又莫半切
徹樂	息八音
出次	舎於郊
祝幣	陳玉帛
史辭	自罪責
以禮焉	禮山川
其如此而已雖伯宗若之何伯宗請見之	見之於晉君見賢遍切注皆同
不可	不肯見
遂以告而從之	從重人言
○許靈公愬鄭伯于楚	前此年鄭伐許故
六月鄭悼公如楚訟不勝楚人執皇戍及子國	以鄭伯不直故也子國鄭穆公子
故鄭伯歸使公子偃請成于晉秋八月鄭伯及晉趙同盟于垂棘	垂棘晉地
〇宋公子圍龜爲質于楚而還	圍龜文公子質音致下注同
華元享之請鼔譟以出鼓譟以復入	出入輒擊鼔譟素報切復扶又切下同
曰習攻華氏宋公殺之	蓋宣十五年宋楚平後華元使圍龜代己爲質故怨而欲攻華氏
〇冬同盟于蟲牢鄭服也諸侯謀復㑹宋公使向爲人辭以子靈之難	子靈圍龜也宋公不欲㑹以新誅子靈爲辭爲明年侵宋傳向舒亮切難乃旦切一本無之難二字子靈爲辭一本無爲辭二字
○十一月己酉定王崩	經在蟲牢盟上傳在下月倒錯衆家傳悉無此八字或衍文倒丁老切
經六年春王正月公至自㑹	無傳
〇二月辛巳立武宫	魯人自鞌之功至今無患故築武軍又作先君武公宫以告成事欲以示後丗
○取鄟	附庸國也鄟徐音專又市臠切
○衛孫良夫帥師侵宋〇夏六月邾子來朝	無傳
〇公孫嬰齊如晉	嬰齊叔肸子
○壬申鄭伯費卒	前年同盟蟲牢費音秘
○秋仲孫蔑叔孫僑如帥師侵宋〇楚公子嬰齊帥師伐鄭〇冬季孫行父如晉〇晉欒書帥師救鄭傳六年春鄭伯如晉拜成	謝前年再盟
子游相	子游公子偃相息亮切下寗相同
授玉于東楹之東	禮授玉兩楹之間鄭伯行疾故東過
士貞伯曰鄭伯其死乎自棄也巳視流而行速不安其位宜不能乆	視流不端諦諦音帝
○二月季文子以鞌之功立武宫非禮也	宣十二年潘黨勸楚子立武軍楚子荅以武有七德非己所堪其爲先君宫告成事而巳今魯倚晉之功又非霸主而立武宫故譏之倚於綺切
聽於人以救其難不可以立武立武由己非由人也	言請人救難勝非己功難乃旦切注同
○取鄟言易也	易以䜴切
○三月晉伯宗夏陽說衛孫良夫寗相鄭人伊雒之戎陸渾蠻氏侵宋	夏陽說晉大夫蠻氏戎别種也河南新城縣東南有蠻城經准書衛孫良夫獨衛告也夏戸雅切說音恱下文注同渾戸門切種章勇切
以其辭㑹也	辭㑹在前年
師于鍼衛人不保	不守備鍼其廉切一音針
說欲襲衛曰雖不可入多俘而歸有罪不及死伯宗曰不可衛唯信晉故師在其郊而不設備若襲之是棄信也雖多衛俘而晉無信何以求諸侯乃止師還衛人登陴	聞說謀故陴毗支切
〇晉人謀去故絳	晉復命新田爲絳故謂此故絳復扶又切
諸大夫皆曰必居郇瑕氏之地	郇瑕古國名河東解縣西北有郇城郇音荀解音蟹
沃饒而近盬	盬鹽也猗氏縣鹽池是近附近之近下及注近寳皆同盬音古猗於冝切
國利君樂不可失也韓獻子將新中軍且爲僕大夫	兼大僕樂音洛下謂樂同將子匠切下注將軍同大音泰
公揖而入獻子從公立於寢庭	路寢之庭
謂獻子曰何如	問諸大夫言是非
對曰不可郇瑕氏土薄水淺	土薄地下
其惡易覯	惡疾疹覯成也易以䜴切下注同覯古豆切疹勑覲切本或作疢同
易覯則民愁民愁則墊隘	墊隘羸困也墊丁念切隘於賣切羸劣僞切
於是乎有沉溺重膇之疾	沉溺濕疾重膇足腫溺刀歷切膇治僞切二音直媿切腫章勇切一音常勇切
不如新田	今平陽絳邑縣是
土厚水深居之不疾	髙燥故
有汾澮以流其惡	汾水出太原經絳北西南入河澮水出平陽絳縣南西入汾惡垢穢汾扶云切澮古外切垢古口切
且民從敎	無災患
十丗之利也夫山澤林盬國之寳也國饒則民驕佚	財易致則民驕侈佚音逸
近寳公室乃貧不可謂樂	近寳則民不務本
公說從之夏四月丁丑晉遷于新田	爲季孫如晉傳說音恱
○六月鄭悼公卒	終士貞伯之言
○子叔聲伯如晉命伐宋	晉人命聲伯
秋孟獻子叔孫宣伯侵宋晉命也〇楚子重伐鄭鄭從晉故也	前年從晉盟
○冬季文子如晉賀遷也○晉欒書救鄭與楚師遇於繞角	繞角鄭地
楚師還晉師遂侵蔡楚公子申公子成以申息之師救蔡	申息楚二縣成音城
禦諸桑隧	汝南朗陵縣東有桑里在上蔡西南禦魚吕切隧音遂
趙同趙括欲戰請於武子武子將許之	武子欒書
知莊子	荀首中軍佐
范文子	士爕上軍佐
韓獻子	韓厥新中軍將
諫曰不可吾來救鄭楚師去我吾遂至於此	此蔡地
是遷戮也戮而不巳又怒楚師戰必不克	遷戮不義怒敵難當故不克
雖克不令成師以出而敗楚之二縣何榮之有焉	六軍悉出故曰成師以大勝小不足爲榮
若不能敗爲辱巳甚不如還也乃遂還於是軍帥之欲戰者衆或謂欒武子曰聖人與衆同欲是以濟事子盍從衆	盍何不也帥所類切下注同盍戸臘切
子爲大政	中軍元帥
將酌於民者也	酌取民心以爲政
子之佐十一人	六軍之卿佐
其不欲戰者三人而巳	知范韓也
欲戰者可謂衆矣商書曰三人占從二人衆故也	商書洪範
武子曰善鈞從衆	鈞等也
夫善衆之主也三卿爲主可謂衆矣	三卿皆晉之賢人
從之不亦可乎	傳善欒書得從衆之義且爲八年晉侵蔡傳
經七年春王正月鼷䑕食郊牛角改卜牛鼷䑕又食其角乃免牛	無傳稱牛未卜日免放也免牛可也不郊非禮也鼷音兮
〇呉伐郯	郯音談
〇夏五月曹伯來朝○不郊猶三望	無傳書不郊間有事三望非禮
〇秋楚公子嬰齊帥師伐鄭〇公㑹晉侯齊侯宋公衛侯曹伯莒子邾子𣏌伯救鄭〇八月戊辰同盟于馬陵	馬陵衛地陽平元城縣東南有地名馬陵
○公至自㑹	無傳
〇呉入州來	州來楚邑淮南下蔡縣是也
〇冬大雩	無傳書過
〇衛孫林父出奔晉傳七年春呉伐郯郯成季文子曰中國不振旅蠻夷入伐而莫之或恤	振整也旅衆也
無弔者也夫	言中國不能相愍恤故夷狄内侵夫音扶
詩曰不弔昊天亂靡有定其此之謂乎	詩小雅刺在上者不能弔愍下民故號天告亂昊戸老切號户刀切
有上不弔其誰不受亂	上謂霸主
吾亡無日矣君子曰知懼如是斯不亡矣○鄭子良相成公以如晉見且拜師	謝前年晉救鄭之師爲楚伐鄭張本相息亮切見賢遍切
夏曹宣公來朝秋楚子重伐鄭師于汜	汜鄭地在襄城縣南氾音凡
諸侯救鄭鄭共仲侯羽軍楚師	二子鄭大夫共音恭
囚鄖公鍾儀獻諸晉○八月同盟于馬陵㝷蟲牢之盟且莒服故也	蟲牢盟在五年莒本屬齊齊服故莒從之鄖本亦作貟音云邑名
〇晉人以鍾儀歸囚諸軍府	軍藏府也爲九年晉侯見鍾儀張本藏才浪切
楚圍宋之役	在宣十四年
師還子重請取於申吕以爲賞田王許之	分申吕之田以自賞
申公巫臣曰不可此申吕所以邑也是以爲賦以御北方若取之是無申吕也	言申吕頼此田成邑耳不得此田則無以出兵賦而二邑壞也所邑也一本作所以邑也御魚吕切
晉鄭必至于漢王乃止子重是以怨巫臣子反欲取夏姬巫臣止之遂取以行子反亦怨之及共王即位	楚共王以魯成公元年即位共音恭
子重子反殺巫臣之族子閻子蕩及清尹弗忌	皆巫臣之族閻音鹽
及襄老之子黒要	以夏姬故井怨黒要要一遥切
而分其室子重取子閻之室使沈尹與王子罷分子蕩之室子反取黒要與清尹之室巫臣自晉遺二子書	子重子反罷音皮下同遺唯季切
曰爾以讒慝貪惏事君而多殺不辜余必使爾罷於奔命以死巫臣請使於呉晉侯許之呉子壽夢說之乃通呉于晉	壽夢季札父慝他得切惏力含切使所吏切夢莫公切說音恱札側八切
以兩之一卒適呉舎偏兩之一焉	司馬法百人爲卒二十五人爲兩車九乗爲小偏十五乗爲大偏蓋留九乗車及一兩二十五人今呉習之卒子忽切注同舎音赦舊音捨乗繩證切下注同令力呈切
與其射御敎呉乗車敎之戰陳敎之叛楚	前是呉常屬楚陳直覲切
寘其子狐庸焉使爲行人於呉呉始伐楚伐巢伐徐	巢徐楚屬國寘之䜴切
子重奔命	救徐巢
馬陵之㑹呉入州來子重自鄭奔命	因伐鄭而行
子重子反於是乎一歳七奔命蠻夷屬於楚者呉盡取之是以始大通呉於上國	上國諸夏夏戸雅切
衛定公惡孫林父冬孫林父出奔晉	林父孫良夫之子惡烏路切
衛侯如晉晉反戚焉	戚林父邑休父出奔戚隨屬晉戚七狄切
經八年春晉侯使韓穿來言汶陽之田歸之于齊	齊服事晉故晉來語魯使還二年所取田語魚據切
〇晉欒書帥師侵蔡〇公孫嬰齊如莒〇宋公使華元來聘○夏宋公使公孫壽來納幣	昏聘不使卿今華元將命故特書之宋公無主昏者自命之故稱使也公孫壽蕩意諸之父
〇晉殺其大夫趙同趙括	傳曰原屏咎之徒也明本不以德義自居冝其見討故從告辭而稱名
〇秋七月天子使召伯來賜公命	諸侯即位天子賜以命圭與之合瑞八年乃來緩也天子天王王者之通稱稱尺證切
〇冬十月癸卯𣏌叔姬卒	前五年來歸者女旣適人雖見出弃猶以成人禮書之終爲𣏌伯所葬故稱杞叔姬
〇晉侯使士爕來聘〇叔孫僑如㑹晉士爕齊人邾人伐郯	先謀而稱㑹盟主之命不同之於列國
〇衛人來媵	古者諸侯取適夫人及左右媵各有姪娣皆同姓之國國三人凡九女所以廣繼嗣也魯將嫁伯姬於宋故衛來媵之媵以證切又繩證切適丁歷切姪大結切字林丈一切娣大計切
傳八年春晉侯使韓穿來言汶陽之田歸之于齊季丈子餞之	餞送行飲酒餞錢淺切說文云送去食也字林子扇切毛詩箋云祖而舎軷飲酒於其側曰餞
私焉	私與之言
曰大國制義以爲盟主是以諸侯懷德畏討無有貳心謂汶陽之田敝邑之舊也而用師於齊使歸諸敝邑	用師鞌之戰
今有二命曰歸諸齊信以行義義以成命小國所望而懷也信不可知義無所立四方諸侯其誰不解體	言不復肅敬於晉復扶又切
詩曰女也不爽士貳其行士也罔極二三其德	爽差也極中也詩衛風婦人怨丈夫不一其行喻魯事晉猶女之不敢過差而晉有罔極之心反二三其德行下孟切及注同差初賣切一音初佳切
七年之中一與一奪二三孰甚焉士之二三猶喪妃耦而況霸主霸主將德是以	以用也喪息浪切妃辛配耦五口切
而二三之其何以長有諸侯乎詩曰猶之未逺是用大簡	猶圖也簡諫也詩大雅言王者圖事不逺故用大道諫之長音如字一音丁丈切
行父懼晉之不逺猶而失諸侯也是以敢私言之〇晉欒書侵蔡	六年未得志故
遂侵楚獲申驪	申驪楚大夫驪力馳切
楚師之還也	謂六年遇於繞角時
晉侵沈獲沈子揖初從知范韓也	繞角之役欒書從知莊子范文子韓獻子之言不與楚戰自是常從其謀師出有功故傳善之沈國今汝南平與縣揖徐音集又於立切與音餘一音預
君子曰從善如流冝哉	冝有功也如流喻速
詩曰愷悌君子遐不作人	遐逺也作用也詩大雅言文王能逺用善人不語助愷開在切樂也悌徒禮切易也
求善也夫作人斯有功績矣是行也鄭伯將㑹晉師	㑹伐蔡之師夫音扶
門于許東門大獲焉	過許見其無備因攻之過古禾切
〇聲伯如莒逆也	自爲逆婦而書者因聘而逆爲于僞切下文爲趙嬰同
宋華元來聘聘共姬也	穆姜之女成公姊妹爲來共公夫人聘不應使卿故傳發其事而巳共音恭
〇夏宋公使公孫壽來納幣禮也	納幣應使卿
〇晉趙莊姬爲趙嬰之亡故譛之于晉侯	趙嬰亡在五年
曰原屏將爲亂欒郤爲徴	欒氏郤氏亦徴其爲亂
六月晉討趙同趙括武從姬氏畜于公宫	趙武莊姬之子莊姬晉成公女畜養也
以其田與祁奚韓厥言於晉侯曰成季之勲宣孟之忠	成季趙衰宣孟趙盾祁巨之切字林上尸切衰初危切盾徒本切
而無後爲善者其懼矣三代之令王皆數百年保天之禄夫豈無辟王頼前哲以免也	言三代亦有邪辟之君但頼其先人以免禍耳數所主切辟匹亦切注及下同哲陟列切邪似嗟切
周書曰不敢侮鰥寡所以明德也	周書康誥言文王不侮鰥寡而德益明欲使晉侯之法文王侮亡甫切鰥古頑切
乃立武而反其田焉〇秋召桓公來賜公命	召桓公周卿士
○晉侯使申公巫臣如呉假道于莒與渠丘公立於池上	渠丘公莒子朱也池城池也渠丘邑名莒縣有蘧里蘧其居切
曰城巳惡莒子曰辟陋在夷其孰以我爲虞	虞度也巳惡如字巳猶太也本或作城巳惡矣度待洛切
對曰夫狡焉	狡猾之人狡交卯切猾于八切
思啓對疆以利社稷者何國蔑有唯然故多大國矣唯或思或縱也	丗有思開封疆者有縱其暴掠者莒人當唯此爲命疆居良切唯然音維本或作雖後人改也掠音亮
勇夫重閉況國乎	爲明年莒潰傳重直龍切又直勇切閉補計切又補結切一音戸旦切
〇冬𣏌叔姬卒來歸自𣏌故書	愍其見出來歸故書卒也若更適大夫則不復書卒復扶又切
〇晉士爕來聘言伐郯也以其事呉故	七年郯與呉成
公賂之請緩師文子不可	文子士爕
曰君命無貳失信不立禮無加貨事無二成	公私不兩成
君後諸侯是寡君不得事君也	欲與魯絶後如字徐音胡豆切
爕將復之季孫懼使宣伯帥師㑹伐郯〇衛人來媵共姬禮也凡諸侯嫁女同姓媵之異姓則否	必以同姓者參骨肉至親所以息隂訟
經九年春王正月𣏌伯來逆叔姬之喪以歸〇公㑹晉侯齊侯宋公衛侯鄭伯曹伯莒子杞伯同盟于蒲	蒲衛地在長垣縣西南
〇公至自㑹	無傳
〇二月伯姬歸于宋	宋不使卿逆非禮
〇夏季孫行父如宋致女	女嫁三月又使大夫隨加聘問謂之致女所以致成婦禮篤昏姻之好好呼報切
〇晉人來媵	媵伯姬也
○秋七月丙子齊侯無野卒	無傳五同盟丙子六月一日書七月從赴
〇晉人執鄭伯	鄭伯旣受盟於蒲又受楚賂㑹於鄧故晉執之稱人者晉以無道於民告諸侯例在十五年
〇晉欒書帥師伐鄭〇冬十有一月葬齊頃公	無傳頃音傾
〇楚公子嬰齊帥師伐莒庚申莒潰	民逃其上曰潰
〇楚人入鄆	鄆莒别邑也楚偏師入鄆故稱人
〇秦人白狄伐晉〇鄭人圍許〇城中城	魯邑也在東海廩丘縣西南此閏月城在十一月之後十二月之前故傳曰書時
傳九年春𣏌桓公來逆叔姬之喪請之也	叔姬巳絶於𣏌魯復強請𣏌使還取葬復扶又切下同強其丈切
𣏌叔姬卒爲𣏌故也	還爲𣏌婦故卒稱𣏌爲于僞切下注爲魯下文爲歸汶陽同
逆叔姬爲我也	旣棄而復逆其喪明爲魯故逆叔姬絶句爲我也本或無爲字
〇爲歸汶陽之田故諸侯貳於晉	歸田在前年
晉人懼㑹於蒲以㝷馬陵之盟	馬陵盟在七年
季文子謂范文子曰德則不競㝷盟何爲	競強也
范文子曰勤以撫之寛以待之堅彊以御之明神以要之柔服而伐貳德之次也是行也將始㑹呉呉人不至	爲十五年㑹鍾離傳御魚吕切要一遥切
〇二月伯姬歸于宋	爲致女復命起
〇楚人以重賂求鄭鄭伯㑹楚公子成于鄧	爲晉人執鄭伯傳
〇夏季文子如宋致女復命公享之賦韓奕之五章	韓奕詩大雅篇名其五章言蹶父嫁女於韓侯爲女相所居莫如韓樂文子喻魯侯有蹶父之德宋公如韓侯宋士如韓樂蹶九衛切爲于僞切相息亮切樂音洛下同
穆姜出于房再拜曰大夫勤辱不忘先君以及嗣君施及未亡人	穆姜伯姬母聞文子言宋樂喜而出謝其行勞婦人夫死自稱未亡人施以䜴切
先君猶有望也	言先君亦望文子之若此
敢拜大夫之重勤又賦緑衣之卒章而入	緑衣詩邶風也取其我思古人實獲我心喻文子言得己意重直勇切又直用切緑如字本又作禒吐亂切注同邶音佩又作鄁
〇晉人來媵禮也	同姓故
〇秋鄭伯如晉晉人討其貳於楚也執諸銅鞮	銅鞮晉别縣在上黨鞮丁兮切
〇欒書伐鄭鄭人使伯蠲行成晉人殺之非禮也兵交使在其間可也	明殺行人例蠲古玄切又音圭使音所吏切
楚子重侵陳以救鄭	陳與晉故
〇晉侯觀于軍府見鍾儀問之曰南冠而縶者誰也	南冠楚冠縶拘執縶中立切拘九于切
有司對曰鄭人所獻楚囚也使稅之	鄭獻鍾儀在七年稅解也稅吐活切徐始銳切注同
召而弔之再拜稽首問其族對曰泠人也	泠人樂官泠力丁切依字作伶
公曰能樂乎對曰先人之職官也敢有二事	言不敢學他事
使與之琴操南音	南音楚聲操七刀切下同
公曰君王何如對曰非小人之所得知也固問之對曰其爲大子也師保奉之以朝于嬰齊而夕于側也	嬰齊令尹子重側司馬子反言其尊卿敬老
不知其他公語范文子文子曰楚囚君子也言稱先職不背本也樂操土風不忘舊也稱大子抑無私也	舎其近事而逺稱少小以示性所自然明至誠語魚據切背音佩下同舎音捨少詩照切
名其二卿尊君也	尊晉君也
不背本仁也不忘舊信也無私忠也尊君敏也	敏達也
仁以接事信以守之忠以成之敏以行之事雖大必濟	言有此四德必能成大事
君盍歸之使合晉楚之成公從之重爲之禮使歸求成	爲下十二月晉楚結成張本盍戸臘切
○冬十一月楚子重自陳伐莒圍渠丘渠丘城惡衆潰奔莒戊申楚入渠丘	月六日
莒人囚楚公子平楚人曰勿殺吾歸而俘莒人殺之楚師圍莒莒城亦惡庚申莒潰	月十八日
楚遂入鄆莒無備故也	終巫臣之言
君子曰恃陋而不備罪之大者也備豫不虞善之大者也莒恃其陋而不脩城郭浹辰之間而楚克其三都無備也夫	浹辰十二日也浹子協切徐又音子荅切夫音扶
詩曰雖有絲麻無棄菅蒯雖有姬姜無棄蕉萃凡百君子莫不代匱言備之不可以巳也	逸詩也姬姜大國之女蕉萃陋賤之人菅古顔切蒯苦怪切蕉在遥切萃在醉切匱其位切
〇秦人白狄伐晉諸侯貳故也〇鄭人圍許示晉不急君也	此秋晉執鄭伯
是則公孫申謀之曰我出師以圍許	示不畏晉
爲將改立君者而紓晉使	紓緩也勿亟遺使詣晉示欲更立君爲將並如字或于僞切非也本或作僞將紓音舒使所吏切亟紀力切急也或欺冀切數也
晉必歸君	爲明年晉侯歸鄭伯張本
○城中城書時也〇十二月楚子使公子辰如晉報鍾儀之使請脩好結成	鍾儀奉晉命歸故楚報之好呼報切
經十年春衛侯之弟黒背帥師侵鄭〇夏四月五卜郊不從乃不郊	無傳卜常祀不郊皆非禮故書
〇五月公㑹晉侯齊侯宋公衛侯曹伯伐鄭	晉侯大子州蒲也稱爵見其生代父居位失人子之禮見賢遍切
〇齊人来媵	無傳媵伯姬也異姓來媵非禮也
〇丙午晉侯獳卒	六同盟據傳丙午六月七日有日無月獳乃侯切
〇秋七月公如晉〇冬十月傳十年春晉侯使糴茷如楚	糴茷晉大夫糴徐徒弔切一音杜敖切又土弔切茷扶廢切一音蒲發切又蒲女切
報大宰子商之使也	子商楚公子辰使在前年大音泰使所吏切下使在同
〇衛子叔黒背侵鄭晉命也	晉命衛使侵鄭
〇鄭公子班聞叔申之謀	改立君之謀
三月子如立公子繻	子如公子班繻音須
夏四月鄭人殺繻立髠頑子如奔許	髠頑鄭成公大子髠苦門切頑如字徐音五班切
欒武子曰鄭人立君我執一人焉何益不如伐鄭而歸其君以求成焉晉侯有疾五月晉立大子州蒲以爲君而㑹諸侯伐鄭	生立子爲君此父不父子不子經因書晉侯其惡明州蒲本或作州滿
鄭子罕賂以襄鐘	子罕穆公子襄鐘鄭襄公之廟鐘
子然盟于脩澤子駟爲質	子然子駟皆穆公子榮陽卷縣東有脩武亭質音致卷音權字林丘權切如淳漢書音同
辛巳鄭伯歸	鄭伯歸不書鄭不告入
〇晉侯夢大厲被髮及地搏膺而踊曰殺余孫不義	厲鬼也趙氏之先祖也八年晉侯殺趙同趙括故怒被皮寄切博音博踊音勇
余得請於帝矣壞大門及寢門而入公懼入于室又壞戸公覺召桑田巫	桑田晉邑壞音怪下同及寢門一本無及字覺古孝切
巫言如夢	巫云鬼怒如公所夢
公曰何如曰不食新矣	言公不得及食新麥
公疾病求醫于秦秦伯使醫緩爲之	緩醫名爲猶治也醫於其切
未至公夢疾爲二豎子曰彼良醫也懼傷我焉逃之其一曰居肓之上膏之下若我何	肓鬲也心下爲膏傷我絶句焉徐於䖍切一讀如字屬上句逃之絶句肓徐音荒說文云心下鬲上也鬲音革
醫至曰疾不可爲也在肓之上膏之下攻之不可達之不及藥不至焉不可爲也	達針攻音工
公曰良醫也厚爲之禮而歸之六月丙午晉侯欲麥	周六月今四月麥始熟
使甸人獻麥	甸人主爲公田者甸徒練切
饋人爲之召桑田巫示而殺之將食張如廁陷而卒	張腹蒲也饋其媿切爲如字張中亮切注同
小臣有晨夢負公以登天及日中負晉侯出諸厠遂以爲殉	傳言巫以明術見殺小臣以言夢自禍
〇鄭伯討立君者戊申殺叔申叔禽	叔禽叔申弟
君子曰忠爲今德非其人猶不可況不令乎	言叔申爲忠不得其人還害身
○秋公如晉	親弔非禮
晉人止公使送葬於是糴茷未反	是春晉使糴茷至楚結成晉謂魯二於楚故留公須糴茷還驗其虚實
冬葬晉景公公送葬諸侯莫在魯人辱之故不書諱之也	諱不書晉葬也
春	_
秋	_
左	_
氏	_
傳	_
卷	_
第	_
十	_
二	_
