春秋經傳集解哀上第二十九	哀公名蔣定公之子蓋夫人定姒所生敬王二十八年即位謚法恭仁短折曰哀
杜氏盡十三年經元年春王正月公即位	無傳
○楚子陳侯隨侯許男圍蔡	隨丗服於楚不通中國呉之入楚昭王奔隨隨人免之卒復楚國楚人德之使列於諸侯故得見經定六年鄭滅許此復見者蓋楚封之見賢遍切復扶又切
○鼷䑕食郊牛改卜牛夏四月辛巳郊	無傳書過也不言所食所食非一處處昌慮切
○秋齊侯衛侯伐晉○冬仲孫何忌帥師伐邾	無傳
傳元年春楚子圍蔡報柏舉也	在定四年
里而栽	栽設板築爲圍壘周帀去蔡城一里栽才代切又音再注同說文云築牆長版壘力軌切帀子合切
廣丈髙倍	壘厚一丈髙二丈廣古曠切髙倍並如字髙又古報切厚古豆切
夫屯晝夜九日	夫猶兵也壘未成故令人在壘裏屯守蔡屯徒門切注同屯守也令力呈切
如子西之素	子西本計爲壘當用九日而成
蔡人男女以辨	辨别也男女各别係纍而出降辨扶免切又方免切別彼列切纍力維切降戸江切
使疆于江汝之間而還	楚欲使蔡徙國在江水之北汝水之南求田以自安也蔡權聽命故楚師還疆居良切
蔡於是乎請遷于呉	楚旣還蔡人更叛楚就呉爲明年蔡遷州來傳
○呉王夫差敗越于夫椒報檇李也	檇李在定十四年夫椒呉郡呉縣西南大湖中椒山夫音扶椒作子消切檇音醉大音泰
遂入越越子以甲楯五千保于㑹稽	上㑹稽山也㑹稽在山隂縣南楯食允切又音允㑹古外切稽古兮切上時掌切
使大夫種因呉大宰嚭以行成呉子將許之伍貟曰不可臣聞樹德莫如滋去疾莫如盡昔有過澆殺斟灌以伐斟鄩	澆寒浞子封於過者二斟夏同姓諸侯襄四年傳曰澆用師滅斟灌嚭普鄙切貟音云去起吕切一本又作去惡過古禾切國名澆五叫切又五報切斟之林切灌古亂切鄩音尋浞仕捉切夏戸雅切
滅夏后相	夏后相啓孫也后相失國依於二㪸復爲澆所滅相息亮切復扶又切
后緍方娠逃出自竇	后緍相妻娠懷身也緍亡巾切娠音震又音身竇音豆
歸于有仍	后緍有仍氏女
生少康焉爲仍牧正	牧官之長少詩照切長丁丈切
惎澆能戒之	惎毒也戒備也惎音忌
澆使椒求之	椒澆臣
逃奔有虞爲之庖正以除其害	虞舜後諸侯也梁國有虞縣庖正掌膳羞之官頼此以得除己害庖歩交切
虞思於是妻之以二姚	思有虞君也虞思自以二女妻少康姚虞姓妻七計切姚芉昭切
而邑諸綸	綸虞邑綸音倫
有田一成有衆一旅	方十里爲成五百人爲旅
能布其德而兆其謀	兆始
以收夏衆撫其官職	襄四年傳曰靡自有鬲氏􁑏二國之燼以滅浞而立少康鬲音革燼徐刃切又秦刃切
使女艾諜澆	女艾少康臣諜候也女如字又音汝艾五蓋切諜音牒
使季杼誘豷	豷澆弟也季杼少康子后杼也杼直吕切豷許器切
遂滅過戈復禹之績	過澆國戈豷國過戈並古禾切績一本作迹
祀夏配天不失舊物	物事也
今呉不如過而越大於少康或將豐之不亦難乎	言與越成是使越豐大必爲呉難難乃旦切
句踐能親而務施施不失人	所加惠賜皆得其人施始䜴切
親不棄勞	推親愛之誠則不遺小勞
與我同壤而丗爲仇讎於是乎克而弗取將又存之違天而長寇讎	猶言天與不取長丁丈切
後雖悔之不可食巳	食消也已止也
姬之衰也日可俟也	姬呉姓言可計日而待俟本又作娭音仕
介在蠻夷而長寇讎以是求伯必不行矣弗聽退而告人曰越十年生聚而十年敎訓	生民聚財富而後敎之介音界伯如字又音霸聚才喻切又如字
二十年之外呉其爲沼乎	謂吳宫室廢壞當爲汙池爲二十二年越入呉起本沼之兆切汙音烏
三月越及呉平呉入越不書呉不告慶越不告敗也	嫌夷狄不與華同故復發傳復扶又切
○夏四月齊侯衛侯救邯鄲圍五鹿	趙稷以邯鄲叛范中行氏之黨也五鹿晉邑邯音寒鄲音丹
○呉之入楚也	在定四年
使召陳懷公懷公朝國人而問焉曰欲與楚者右欲與呉者左陳人從田無田從黨	都邑之人無田者隨黨而立不知所與故直從所居田在西者居右在東者居左
逢滑當公而進	當公不左不右滑于八切
曰臣聞國之興也以福其亡也以禍今呉未有福楚未有禍楚未可棄呉未可從而晉盟主也若以晉辭呉若何公曰國勝君亡非禍而何	楚爲呉所勝
對曰國之有是多矣何必不復小國猶復況大國乎臣聞國之興也視民如傷是其福也	如傷恐驚動
其亡也以民爲土芥是其禍也	芥草也芥古邁切
楚雖無德亦不艾殺其民呉日敝於兵暴骨如莽	草之生於廣野莾莽然故曰草莽艾魚廢切暴歩卜切莽亡黨切
而未見德焉天其或者正訓楚也	使懼而改過
禍之適呉其何日之有	言今至
陳侯從之及夫差克越乃脩先君之怨秋八月呉侵陳脩舊怨也	傳言呉不脩德而脩怨所以亡
○齊侯衛侯㑹于乾侯救范氏也師及齊師衛孔圉鮮虞人伐晉取棘蒲	魯師不書非公命也孔圉孔烝鉏曾孫鮮虞狄帥賤故不書圉魚吕切烝之承切鉏仕居切
○呉師在陳楚大夫皆懼曰闔廬惟能用其民以敗我於柏舉今聞其嗣又甚焉將若之何子西曰二三子恤不相睦無患呉矣昔闔廬食不二味居不重席室不崇壇	平地作室不起壇也重直龍切壇徒丹切
器不彤鏤	彤丹也鏤刻也彤徒冬切鏤魯豆切
宫室不觀	觀臺榭觀古亂切榭音謝
舟車不飾衣服財用擇不取費	選取堅厚不尚細靡費芳味切
在國天有菑癘	癘疾疫也葘音災本或作天無菑癘非注同疫音役
親巡孤寡而共其乏困在軍熟食者分而後敢食	必須軍士皆分熟食不敢先食分猶徧也共音恭熟食者分如字一讀以分字連下句徧音遍
其所甞者卒乗與焉	所甞甘珍非常食卒子忽切乗繩證切與音預
勤恤其民而與之勞逸是以民不罷勞死知不曠	知身死不見曠棄罷音皮
吾先大夫子常易之所以敗我也	易猶反也
今聞夫差次有臺榭陂池焉	積土爲髙曰臺有木曰榭過再宿曰次陂披冝切
宿有妃嬙嬪御焉	妃嬙貴者嬪御賤者皆内官嬙本又作廧或作嬙在羊切嬪毗人切
一日之行所欲必成玩好必從珍異是聚觀樂是務視民如讎而用之日新夫先自敗也巳安能敗我	爲二十二年越滅呉起好呼報切夫先自敗也巳夫音扶本或作夫差先自敗者非
○冬十一月晉趙鞅伐朝歌	討范中行氏
經二年春王二月季孫斯叔孫州仇仲孫何忌帥師伐邾取漷東田及沂西田	邾人以賂取之易也漷火虢切又音郭沂魚依切易以䜴切
○癸巳叔孫州仇仲孫何忌及邾子盟于句繹	句繹邾地取邑盟以要之句古侯切繹音亦要以遥切
○夏四月丙子衛侯元卒	定四年盟臯鼬
○滕子來朝	無傳
○晉趙鞅帥師納衛丗子蒯聵于戚○秋八月甲戌晉趙鞅帥師及鄭罕達帥師戰于鐵鄭師敗績	皆陳曰戰大崩曰敗績鐵在戚城南罕達子皮孫鐵天結切陳直覲切
○冬十月葬衛靈公	無傳七月而葬緩
○十有一月蔡遷于州來	長楚而請遷故以自遷爲文
○蔡殺其大夫公子駟	懷土而欺大國故罪而書名
傳二年春伐邾將伐絞	絞邾邑絞古卯切
邾人愛其土故賂以漷沂之田而受盟○初衛侯遊于郊子南僕	子南靈公子郢也僕御也郢以井切
公曰余無子將立女	蒯聵奔無大子女音汝
不對他日又謂之對曰郢不足以辱社稷君其改圖君夫人在堂三揖在下	三揖卿大夫士揖一入切
君命祗辱	言立適當以禮與外内同之今君私命事必不從適爲辱祗音支適丁歷切下適孫同
夏衛靈公卒夫人曰命公子郢爲大子君命也對曰郢異於他子	言用意不同
且君没於吾手若有之郢必聞之	言當以臨没爲正
且亡人之子輒在	輒蒯聵之子出公也靈公適孫
乃立輒六月乙酉晉趙鞅納衛大子于戚宵迷陽虎曰右河而南必至焉	是時河北流過元城界戚在河外晉軍巳渡河故欲出河右而南
使大子絻	絻者始發喪之服絻音問喪音桑
八人衰絰僞自衛逆者	欲爲衛人逆故衰絰成服衰七雷切絰田結切
告於門哭而入遂居之○秋八月齊人輸范氏粟鄭子姚子般送之	子姚罕達子般駟弘般音班
士吉射逆之趙鞅禦之遇於戚陽虎曰吾車少以兵車之旆與罕駟兵車先陳	旆先驅車也以先驅車益以兵車以示衆陳直覲切
罕駟自後隨而從之彼見吾貌必有懼心	晉人先陳鄭人隨之不知其虚實見車多必懼
於是乎㑹之	㑹合戰
必大敗之從之卜戰龜焦	兆不成
樂丁曰詩曰爰始爰謀爰契我龜	樂丁晉大夫詩大雅言先人事後卜筮契苦計切又苦結切
謀協以故兆詢可也	詢諮詢也故兆始納衛大子卜得吉兆言今旣謀同可不須更卜謀協以故兆絶句詢思遵切
簡子誓曰范氏中行氏反易天明	不事君也
斬艾百姓欲擅晉國而滅其君寡君恃鄭而保焉今鄭爲不道棄君助臣二三子順天明從君命經德義除詬恥在此行也克敵者上大夫受縣下大夫受郡	周書作雖篇千里百縣縣有四郡艾魚廢切擅市戰切而滅其君滅或作戕音殘詬呼豆切又音苟雒音洛千里百縣縣方百里縣有四郡郡方五十里
士田十萬	十萬畝也
庶人工商遂	得遂進仕
人臣隷圉免	去厮役厮役如字字又作斯音同何休注公羊云艾草爲防者曰厮汲水漿者曰役蘇林注漢書云厮取薪者韋昭云析薪曰厮
志父無罪君實圖之	志父趙簡子之一名也言巳事濟君當圖其賞父音甫服云趙鞅入晉陽以畔後得歸改名志父春秋仍舊猶書趙鞅
若其有罪絞縊以戮	絞所以縊人物縊一賜切戮音六
桐棺三寸不設屬辟	屬辟棺之重數王棺四重君再重大夫一重釋文桐棺三寸禮記云夫子制於中都四寸之棺五寸之椁以斯知不欲速朽也鄭康成注云此庶人之制也案禮上大夫棺八十屬六寸下大夫棺六寸屬四寸無三寸棺制也桐用難朽之木桐木易壞不堪爲棺故以為罰墨子尚儉有桐棺三寸不設屬音燭注同次大棺也辟歩歷切注同親身棺也禮大夫無辟重直龍切下同王棺四重禮記云水兕革棺被之其厚三寸柂棺一梓棺二柂棺辟也梓棺二屬與大棺也𬒳水牛及兕之革爲一重辟爲二重屬爲三重大棺爲四重君再重君謂侯伯子男侯伯巳下無革棺屬與辟爲一重大棺爲再重上公則唯無水革耳兄革與辟爲一重屬爲再重大棺爲三重大夫一重大夫唯屬與大棺爲一重今云不設辟者時僣耳非王禮也
素車樸馬	以載柩樸普角切柩其又切
無入于兆	兆葬域
下卿之罰也	爲衆設賞自設罰所以能克敵爲于僞切
甲戌將戰郵無恤御簡子衛大子爲右	郵無恤王良也郵音尤
登鐵上	鐵丘名
望見鄭師衆大子懼自投于車下子良授大子綏而乗之曰婦人也	言其怯怯去業切
簡子巡列曰畢萬匹夫也七戰皆獲有馬百乗死於牖下	畢萬晉獻公卿也皆獲有功死於牖下言得壽終乗繩證切牖羊九切
羣子勉之死不在寇	言有命
繁羽御趙羅宋勇爲右	三子晉大夫
羅無勇麋之	麋束縛也麋丘隕切
吏詰之御對曰痁作而伏	痁瘧疾也詰起吉切痁詩占切瘧魚略切
衛大子禱曰曽孫蒯聵敢昭告皇祖文王	周文王皇大也禱丁老切又丁報切
烈祖康叔	烈顯也
文祖襄公	繼業守文故曰文祖蒯聵襄公之孫
鄭勝亂從	勝鄭聲公名􁑐君助臣爲從於亂
晉午在難	午晉定公名雞乃且切下注爲難同
不能治亂使鞅討之	鞅簡子名
蒯聵不敢自佚備持矛焉	戎右持矛佚音逸矛亡侯切
敢告無絶筋無折骨無面傷以集大事無作三祖羞	集成也筋居銀切
大命之上也駕而乗材兩靷皆絶	村橫木明細小也傳言簡子不讓下自伐
○呉洩庸如蔡納聘而稍納師師畢入衆知之	元年蔡請遷子呉中悔故因聘襲之洩息列切又息引切中丁仲切
蔡侯告大夫殺公子駟以說	殺駟以說呉言不時遷駟之爲
哭而遷墓	將遷與先君辭故哭
冬蔡遷于州來經三年春齊國夏衛石曼姑帥師圍戚	曼姑爲子圍父知其不義故推齊使爲兵首戚不稱衛非叛人曼音萬爲于僞切
○夏四月甲午地震	無傳
○五月辛卯桓宫僖宮災	天火曰災
○季孫斯叔孫州仇帥師城啓陽	無傳魯黨范氏故懼晉比年四城啓陽今琅邪開陽縣
○宋樂髠帥師伐曹	無傳髠苦孫切
○秋七月丙子季孫斯卒○蔡人放其大夫公孫獵于呉	無傳公子駟之黨
○冬十月癸卯秦伯卒	無傳不書名未同盟
○叔孫州仇仲孫何忌帥師圍邾	無傳
傳三年春齊衛圍戚求援子中山	中山鮮虞
○夏五月辛卯司鐸火	司鐸宫名鐸待洛切
火踰公宫桓僖災	桓公僖公廟
救火者皆曰顧府	言常人愛財
南宫敬叔至命周人出御書俟於宫	敬叔孔子弟子南宫閱周人司周書典籍之官御書進於君者也使待命於官閱音恱
曰庀女而不在死	庀具也庀匹婢切女音汝
子服景伯至命宰人出禮書	景伯子服何也宰人冢宰之屬
以待命命不共有常刑	待求之命共音恭
校人乗馬巾車脂轄	校人掌馬巾車掌車乗馬使四四相從爲駕之易校戸敎切乗繩證切下同轄戸瞎切本又作鎋同爲于僞切易以䜴切
百官官備府庫愼守官人肅給	國有火災恐有變難故愼爲備難乃旦切
濟濡帷幕鬱攸從之	鬱攸火氣也濡物於木出用爲濟濟子細切又子禮切帷位悲切幕音莫攸音由
蒙葺公屋	以濡物冐覆公屋葺七入切又子入切
自太廟始外内以悛	悛次也先尊後卑以次救之悛七全切
助所不給有不用命則有常刑無赦公父文伯至命校人駕乗車	乗車公車
季桓子至御公立于象魏之外	象魏門闕
命救火者傷人則止財可爲也命藏象魏	周禮正月縣教令之法千象魏使萬民觀之故謂其書爲象魏縣音玄
曰舊章不可亡也富父槐至曰無備而官辦者猶拾瀋也	槐富父終生之後瀋汁也言不備而責辦不可得父音甫槐音懐辨辦具之辦拾音十瀋尺審切北土呼汁爲瀋
於是乎去表之槀	表表火道風所向者去其槀積去起吕切槀古老切向許亮切積子賜切
道還公宫	開除道周帀公宫使火無相連還本又作環戸關切又音患同
孔子在陳聞火曰其桓僖乎	言桓僖親盡而廟不毀冝爲天所災
○劉氏范氏丗爲婚姻	劉氏周卿士范氏晉大夫
萇弘事劉文公	爲之屬大夫
故周與范氏趙鞅以爲討	責周與范氏
六月癸卯周人殺萇弘	終違天之禍
○秋季孫有疾命正常曰無死	正常桓子之寵臣欲付以從事故勑令勿從己死今力呈切
南孺子之子男也則以告而立之	南孺子季桓子之妻言若生男告公而立之孺如住切
女也則肥也可	肥康子也
季孫卒康子即位旣葬康子在朝	在公朝也
南氏生男正常載以如朝告曰夫子有遺言命其圉臣曰南氏生男則以告於君與大夫而立之今生矣男也敢告遂奔衛康子請退	退辟位也
公使共劉視之	共劉魯大夫共音恭
則或殺之矣乃討之	討殺者
召正常正常不反	畏康子也傳儀言季氏家事
○冬十月晉趙鞅圍朝歌師于其南	范中行所在
荀寅伐其郛	伐其北郭圍郛芳夫切
使其徒自北門入已犯師而出	荀寅使在外救已之徒擊趙氏圍之北門因外内攻得出
癸丑奔邯鄲十一月趙鞅殺士臯夷惡范氏也	惡范氏而殺其族言遷怒惡烏路切
經四年春王二月庚戌盗殺蔡侯申	賤者故稱盗不言殺其君賤盗也殺申志切蔡侯申今本皆如此案宣十七年蔡侯申卒是文侯也今昭侯是其玄孫不容與髙祖同名未詳何者誤也
○蔡公孫辰出奔呉	弑君賊之黨故書名
○葬秦惠公	無傳
○宋人執小邾子	無傳邾子無道於其民故稱人以執
○夏蔡殺其大夫公孫姓公孫霍	皆我君黨姓音生又作生或音性
○晉人執戎蠻子赤歸于楚	晉恥爲楚執諸侯故稱人以告若蠻子不道於其民也赤本屬楚故言歸耻為于爲切
○城西郛	無傳魯西郭備晉也
○六月辛丑亳社災	無傳天火也亳社殷社諸侯有之所以戒亡國亳歩各切
○秋八月甲寅滕子結卒	無傳同盟於臯鼬
○冬十有二月葬蔡昭公	無傳亂故是以緩
○葬滕頃公	無傳
傳四年春蔡昭侯將如呉諸大夫恐其又遷也承	承音懲蓋楚言懲直升切
公孫翩逐而射之入於家人而卒	翩蔡大夫翩音篇射食亦切下同
以兩矢門之衆莫敢進	翩以矢自守其門
文之鍇後至	鍇蔡大夫鍇音楷又音皆又客駭切
曰如牆而進多而殺二人	併行如牆俱進併歩頂切
鍇執弓而先翩射之中肘鍇遂殺之故逐公孫辰而殺公孫姓公孫盱	肝即霍也中丁仲切肘女九切盱況子切
○夏楚人旣克夷虎	夷虎蠻夷叛楚者
乃謀北万左司馬眅申公壽餘葉公諸梁致蔡於負函	三子楚大夫也此蔡之故地人民楚因以爲邑致之者㑹其衆也眅普版切字林匹姦切葉始渉切函音咸
致方城之外於繒關	負函繒關皆楚地繒才陵切
曰呉將泝江入郢	逆流曰泝泝音素郢以井切又以政切
將奔命焉爲一昔之期襲梁及霍	僞辭當備呉夜結期明日便襲梁霍使不知之梁河南梁縣西南故城也梁南有霍陽山皆蠻子之邑也
單浮餘圍蠻氏蠻氏潰	浮餘楚大夫單音善潰戸内切
蠻子赤奔晉隂地	隂地河南山北自上雒以東至陸渾渾戸門切
司馬起豐析與狄戎	楚司馬眅也析縣屬南郷郡析南有豐郷皆楚邑發此二邑人及戎狄析星歷切
以臨上雒左師軍于菟和	菟和山在上雒東也菟音徒
右師軍于倉野	倉野在上雒縣
使謂隂地之命大夫士蔑	命大夫別縣監尹監古銜切
曰晉楚有盟好惡同之若將不廢寡君之願也不然將通於少習以聽命	少習商縣武關也將大開武關道以伐晉少詩照切又如字
士蔑請諸趙孟趙孟曰晉國未寧安能惡於楚必速與之	未寧時有范中行之難難乃旦切
士蔑乃致九州之戎	九州戎在晉隂地陸渾者
將裂田以與蠻子而城之	以詐蠻子
且將爲之卜	卜城爲于僞切
蠻子聽卜遂執之與其五大夫以卑楚師于三戸	今丹水縣比三戸亭卑必利切
司馬致邑立宗焉以誘其遺民	楚復詐爲蠻子作邑立其宗主復扶又切
而盡俘以歸○秋七月齊陳乞弦施衛寗跪救范氏	陳乞僖子弦㢮弦多跪其委切
庚午圍五鹿	五鹿晉地
九月趙鞅圍邯鄲冬十一月邯鄲降荀寅奔鮮虞趙稷奔臨	臨晉邑降戸江切
十二月弦施逆之遂墮臨國夏伐晉取邢任欒鄗逆畤隂人盂壷口	八邑晉地欒在趙國平棘縣西北鄗即髙邑縣也路縣東有壺口關墮許規切邢音刑任音壬欒力官切鄗呼洛切郭璞三蒼解詁音􁂄字林火沃切韋昭呼告切闞駟云讀磽确同畤音止盂音于
㑹鮮虞納荀寅于柏人	晉邑也今趙國柏人縣也弦施與鮮虞㑹也
經五年春城毗	無傳備晉也毗頻夷切
○夏齊侯伐宋	無傳
○晉趙鞅帥師伐衛○秋九月癸酉齊侯杵臼卒	再同盟也杵昌吕切臼求又切
○冬叔還如齊○閏月葬齊景公	無傳
傳五年春晉圍柏人荀寅士吉射奔齊初范氏之臣王生惡張柳朔言諸昭子使爲柏人	爲柏人宰也昭子范吉射也惡烏路切下同柳良乆切
昭子曰夫非而讎乎對曰私讎不及公	公家之事也夫音扶
好不廢過惡不去善義之經也臣敢違之及范氏出	出柏人奔齊好呼報切去起吕切
張柳朔謂其子爾從主勉之我將止死王生授我矣	授我死節
吾不可以僭之遂死於柏人	爲吉則距晉戰死僭子念切後同爲于僞切
○夏趙鞅伐衛范氏之故也遂圍中牟	衛助范氏故也
○齊燕姬生子不成而死	燕姬景公夫人不成未冠也燕於賢切冠古喚切
諸子鬻姒之子荼嬖	諸子庶公子也鬻姒景公妾茶安儒子鬻音育姒音似茶音舒又音徒又丈加切嬖必計切
諸大夫恐其爲大子也言於公曰君之齒長矣未有大子若之何公曰二三子間於憂虞則有疾疢亦姑謀樂何憂於無君	景公意欲立荼而未發故以此言塞大夫請長丁丈切間音閑又音間厠之間又如字疢勑覲切本或作疹乃結切樂音洛
公疾使國惠子髙昭子立荼	惠子國夏昭子髙張
寘羣公子於萊	萊齊東鄙邑寘之䜴切羣或作諸萊音來
秋齊景公卒冬十月公子嘉公子駒公子黔奔衛公子鉏公子陽生來奔	皆景公子在萊者黔巨廉切又音琴鉏仕居切
萊人歌之曰景公死乎不與埋三軍之事乎不與謀師乎師乎何黨之乎	師衆也黨所也之往也稱謚蓋葬後而爲此歌哀羣公子失所與音預埋亡皆切
○鄭駟秦富而侈嬖大夫也而常陳卿之車服於其庭鄭人惡而殺之子思曰詩曰不解于位民之攸塈	子思子産子國參也詩大雅改所也塈息也侈昌氏切又尺氏切惡烏路切解佳賣切暨許器切
不守其位而能乆者鮮矣商頌曰不僭不濫不敢怠皇命以多福	僭差也濫溢也皇暇也言駟秦違詩商頌故受禍鮮息淺切濫力暫切溢音逸
經六年春城邾瑕	無傳備晉也任城亢父縣北有邾婁城瑕音遐任音壬亢苦浪切又音剛父音甫
○晉趙鞅帥師伐鮮虞○呉伐陳○夏齊國夏及髙張來奔	二子阿君廢長立少旣受命又不能全書名罪之也長丁丈切少詩照切
○叔還㑹呉于柤	無傳柤莊加切
○秋七月庚寅楚子軫卒	未同盟而赴以名軫之忍切史記作珍
○齊陽生入于齊	爲陳乞所逆故書入
○齊陳乞弑其君荼	弑荼者朱毛與陽生也而書陳乞所以明乞立陽生而荼見弑則禍由乞始也楚比劫立陳乞流涕子家憚老皆疑於免罪故春秋明而書之以爲弑主弑音試下皆同
○冬仲孫何忌帥師伐邾	無傳
○宋向巢帥師伐曹	無傳
傳六年春晉伐鮮虞治范氏之亂也	四年鮮虞納荀寅子柏人
○呉伐陳復脩舊怨也	元年未得志故也復扶又切
楚子曰吾先君與陳有盟不可以不救乃救陳師于城父	陳盟在昭十三年父音甫
○齊陳乞僞事髙國者	髙飛國夏受命立荼陳乞欲害之故先僞事焉
毎朝必驂乗焉所從必言諸大夫	言其罪也乗繩證切
曰彼皆偃蹇將棄子之命	偃蹇驕敖偃約免切蹇紀晚切敖五報切
皆曰髙國得君	得君寵也
必偪我盍去諸固將謀子子早圖之圖之莫如盡滅之需事之下也	需疑也偪音逼盍戸臘切去起吕切下同需音須一音臨弱待疑也
及朝則曰彼虎狼也見我在子之側殺我無日矣請就之位	欲與諸大夫謀髙國故求就之
又謂諸大夫曰二子者禍矣恃得君而欲謀二三子曰國之多難貴寵之由盡去之而後君定旣成謀矣盍及其未作也先諸作而後悔亦無及也大夫從之夏六月戊辰陳乞鮑牧	牧鮑國孫難乃且切牧州牧之牧
及諸大夫以甲入于公宫昭子聞之與惠子乗如公戰于莊敗	髙國敗也莊六軌之道乗繩證切
國人追之國夏奔莒遂及髙張晏圉弦施來奔	晏圉嬰之子圉施不書非卿圉魚吕切
○秋七月楚子在城父將救陳卜戰不吉卜退不吉王曰然則死也再敗楚師不如死	前巳敗於柏舉今若退還亦是敗
棄盟逃讎亦不如死死一也其死讎乎命公子申爲王不可則命公子結亦不可則命公子啓	申子西結子期啓子閭皆昭王兄
五辭而後許將戰王有疾庚寅昭王攻大冥卒于城父	大冥陣地呉師所在辭本又作辤說文云辭不受也受辛冝辭也辭籕文冥亡丁切
子閭退曰君王舎其子而讓羣臣敢忘君乎從君之命順也	從命可立舎音捨
立君之子亦順也二順不可失也與子西子期謀潜師閉塗逆越女之子章立之而後還	潜師密發也閉塗不通外使也越女昭王妾章惠王
是歲也有雲如衆赤鳥夾日以飛日楚子使問諸周大史周大史曰其當王身乎	日爲人君妖氣守之故以爲當王身雲在楚上唯楚見之故禍不及他國夾古洽切大音泰
若禜之可移於令尹司馬	禜禳祭禜音訓禳如羊切
王曰除腹心之疾而寘諸股肱何益不榖不有大過天其天諸有罪受罰又焉移之遂弗禜𥘉昭王有疾卜曰河爲祟王弗祭大夫請祭諸郊王曰三代命祀祭不越望	諸侯望祀竟内山川星辰祟息遂切
江漢睢漳楚之望也	四水在楚界睢七餘切
禍福之至不是過也不榖雖不德河非所獲罪也遂弗祭孔子曰楚昭王知大道矣其不失國也冝哉夏書曰惟彼陶唐帥彼天常	逸書言堯循天之常道釋文楚昭王知大道矣本或作天道非夏戸雅切此語在尚書五子之歌書無帥彼天常一句下亦微異
有此兾方今失其行亂其紀綱乃滅而亡	滅亡謂夏桀也唐虞及夏同都兾州不易地而亡由於不知大道故行如字又下孟切尚書作厥道乃滅而亡尚書乃作厎滅亡
又曰允出兹在兹由已率常可矣	又逸書言信出已則福亦在己
○八月齊邴意兹來奔	高國黨
○陳僖子使召公子陽生	召在七月今在八月下記事之次
陽生駕而見南郭且于	且于齊公子鉏在魯南郭且子餘切
曰甞獻馬於季孫不入於上乗故又獻此請與子乗之	畏在家人聞其言故欲二人共載以試馬爲辭上乗繩證切
出萊門而告之故	魯郭門也
闞止知之先待諸外	闞止陽生家臣子我也待外欲俱去闞昔暫切
公子曰事未可知反與壬也處	壬陽生子簡公
戒之遂行	戒使無洩言洩息列切
逮夜至於齊國人知之	故以昏至不欲令人知之國人知而不言言陳氏得衆
僖子使子士之母養之	隱於僖子家内子士母僖子妾
與饋者皆入	陳僖子又令陽生隨饋食之人入處公宫饋其位切
冬十月丁卯立之將盟	盟諸大夫
鮑子醉而往其臣差車鮑點	點鮑牧臣也差車王車之官差所冝切點之廉切又如字
曰此誰之命也陳子曰受命于鮑子遂誣鮑子曰子之命也	見其醉故誣之
鮑子曰女忘君之爲孺子牛而折其齒乎而背之也	孺子荼也景公甞銜䋲爲牛使荼牽之荼頓地故折其齒女音汝折之舌切又市列切背音佩
悼公稽首	悼公陽生
曰吾子奉義而行者也若我可不必亡一大夫	言己可爲君必不怨鮑子
若我不可不必亡一公子	公子自謂也恐鮑子殺己故要之
義則進否則退敢不唯子是從廢興無以亂則所願也鮑子曰誰非君之子乃受盟	言陽生亦君之子固可立
使胡姬以安孺子如頼	胡姬景公妾也頼齊邑安號也
去鬻姒	荼之母去起吕切
殺王甲拘江說囚王豹于句竇之丘	三子景公嬖臣荼之黨也拘音俱說音稅句音鉤
公使朱毛告於陳子	朱毛齊大夫
曰微子則不及此然君異於器不可以二器二不匱君二多難敢布諸大夫僖子不對而泣曰君舉不信羣臣乎	舉皆也
以齊國之困困又有憂	内有飢荒之困又有兵革之憂
少君不可以訪是以求長君庶亦能容羣臣乎不然夫孺子何罪毛復命公悔之	悔失言少詩照切長丁丈切夫音扶孺或作同
毛曰君大訪於陳子而圖其小可也	大謂國政小謂殺荼
使毛遷孺子於駘不至殺諸野幕之下葬諸殳冒淳	恐駘人不從故毛駐於野張帳而殺之駘齊邑殳冒淳地名實以冬殺經書秋者史書秋記始事遂連其死通以冬吉魯駘他才切又徒來切幕音莫殳音珠冒亡報切淳音純駐中住切
經七年春宋皇瑗帥師侵鄭○晉魏曼多帥師侵衛○夏公㑹呉于鄫	鄫今琅邪鄫縣瑗于眷切鄫本又作繒才陵切
○秋公伐邾○八月已酉入邾以邾子益來	他國言歸於魯言來内外之辭
○宋人圍曹○冬鄭駟弘帥師救曹傳七年春宋師侵鄭鄭叛晉故也	定八年鄭始叛
○晉師侵衛衛不服也	五年晉伐衛至今未服
○夏公㑹呉于鄫	呉欲霸中國
呉來徴百牢子服景伯對曰先王未之有也呉人曰宋百牢我	是時呉過宋得百牢牢力刀切過古禾切
魯不可以後宋且魯牢晉大夫過十	晉大夫范鞅也在昭二十一年後如字又戸豆切
呉王百牢不亦可乎景伯曰晉范鞅貪而棄禮以大國懼敝邑故敝邑十一牢之君若以禮命於諸侯則有數矣	有常數
君亦棄禮則有淫者矣	淫過也
周之王也制禮上物不過十二	上物天子之牢上如字又時掌切
以爲天之大數也	天有十一次故制禮象之
今棄周禮而曰必百牢亦唯執事呉人弗聽景伯曰呉將亡矣棄天而背本	違周爲背本
不與必棄疾於我	放棄凶疾來伐擊我
乃與之大宰嚭召季康子	嚭吳大夫
康子使子貢辭大宰嚭曰國君道長	蓋言君長大於道路長丁丈切
而大夫不出門此何禮也對曰豈以爲禮畏大國也	畏大國不敢虛國盡行
大國不以禮命於諸侯苟不以禮豈可量也寡君旣共命焉其老豈敢棄其國大伯端委以治周禮仲雍嗣之斷髮文身臝以爲飾豈禮也哉有由然也	大伯周大王之長子仲雍大伯弟也大伯仲雍讓其弟季歷俱適荆蠻遂有民衆大伯卒無子仲雍嗣立不能行禮致化故效呉俗言其權時制冝以辟災害非以爲禮也端委禮衣也共音恭大音泰斷丁管切臝本又作祼力果切效戸孝切
反自鄫以呉爲無能爲也	棄禮知其不能覇也
○季康子欲伐邾乃饗大夫以謀之子服景伯曰小所以事大信也大所以保小仁也背大國不信	大國呉也
伐小國不仁民保於城城保於德失二德者危將焉保	二德信與仁也焉於䖍切
孟孫曰二三子以爲何如	怪諸大夫不言故指問之
惡賢而逆之	孟孫賢景伯欲使大夫不逆其言惡猶安也惡音烏
對曰禹合諸侯於塗山執玉帛者萬國	諸大夫對也諸侯執玉附庸執帛塗山在壽春東北
今其存者無數十焉唯大不字小小不事大也	言諸侯相伐古來以然數所主切
知必危何故不言	知伐邾必危自當言今不言者不危故也大夫以荅孟孫所怪且阿附季孫
魯德如邾而以衆加之可乎	孟孫忿荅大夫今魯德無以勝邾但欲恃衆可乎言不可
不樂而出	季孟意異佞直不同故罷饗樂音岳又音洛
秋伐邾及范門	邾郭門也
猶聞鍾聲	邾不禦寇禦魚吕切
大夫諫不聽茅成子請告於呉	成子邾大夫茅夷鴻
不許曰魯擊柝聞於邾	言以近柝音託以兩太相擊以行夜也字又作柝同聞音問又如字
呉二千里不三月不至何及於我且國内豈不足	言足以距魯
成子以茅叛	髙平西南有茅郷亭
師遂入邾處其公宫衆師晝掠	虜掠取財物也晝中救切掠音亮
邾衆保于繹	繹邾山也在鄒北縣繹音亦鄒側留切
師宵掠以邾子益來	益邾隱公也晝夜掠傳言康子無法
獻于亳社	以其亡國與殷同
囚諸負瑕負瑕故有繹	負瑕魯邑髙平南平陽縣西北有瑕丘城前者魯得邾之繹民使在負瑕故使相就以辱之
邾茅夷鴻以束帛乗韋自請救於呉	無君命故言自乗繩證切
曰魯弱晉而逺呉馮恃其衆	馮依馮皮氷切
而背君之盟辟君之執事	辟陋辟匹亦切
以陵我小國邾非敢自愛也懼君威之不立君威之不立小國之憂也若夏盟於鄫衍	鄫衍即鄫也鄫盟不書吳行夷禮禮儀不典非所以結信義故不録
秋而背之成求而不違	言魯成其所求無違逆也
四方諸侯其何以事君且魯賦八百乗君之貳也	貳敵也魯以八百乗之賦貢于呉言其國大
邾賦六百乗君之私也	爲私屬
以私奉貳唯君圖之呉子從之	爲明年吴伐我傳
○宋人圍曹鄭栢子思曰宋人有曹鄭之患也不可以不救	桓謚
冬鄭師救曹侵宋初曹人或夢衆君子立于社宫	社宫社也
而謀亡曹曹叔振鐸請待公孫彊許之	振鐸曹始祖鐸待洛切彊其良切
且而求之曹無之戒其子曰我死爾聞公孫彊爲政必去之及曹伯陽即位好田弋曹鄙人公孫彊好弋獲白鴈獻之且言田弋之說說之因訪政事大說之有寵使爲司城以聽政夢者之子乃行彊言霸說於曹伯曹伯從之乃背晉而奸宋宋人伐之晉人不救築五邑於其郊曰黍丘揖丘大城鍾䢴	爲明年入曹傳也梁國下邑縣西南有黍丘亭好呼報切弋以職切繳射也上說如字下說音恱䢴大說同霸說如字又始銳切奸音干揖音集又於入切邘音干
經八年春王正月宋公入曹以曹伯陽歸	曹人背晉而奸宋是以致討宋公旣還而不忍禇師之詬怒而反兵一舉滅曹滅非本志故以入告禇中吕切詬呼豆切
○呉伐我○夏齊人取讙及闡	不書伐兵未加而魯與之邑闡在東平剛縣北讙音歡闡尺善切
○歸邾子益于邾○秋七月○冬十有二月癸亥𣏌伯過卒	無傳未同盟而赴以名過古禾切
○齊人歸讙及闡	不言來命歸之無旨使也使所吏切
傳八年春宋公伐曹將還禇師子肥殿	子肥宋大夫殿丁練切
曹人詬之不行	詬辱詈也不行殿兵止也詬本又作訽呼豆切詈力智切
師待之公聞之怒命反之遂滅曹執曹伯及司城彊以歸殺之	終曹人之夢
○呉爲邾故將伐魯問於叔孫輒	問可伐不輒故魯人爲于僞切
叔孫輒對曰魯有名而無情	有大國名無情實
伐之必得志焉退而告公山不狃	不狃亦故魯人狃女九切
公山不狃曰非禮也君子違不適讎國	違奔亡也
未臣而有伐之奔命焉死之可也	未臣所適之國告有伐本國者則可還奔命死其難難乃且切
所託也則隱	曽所因託則爲之隱惡曽在増切
且夫人之行也不以所惡廢郷	不以其私怨惡廢棄其郷黨之好夫音扶行下孟切又如字惡烏路切又如字好呼報切下好焉同
今子以小惡而欲覆宗國不亦難乎	輒魯公族故謂之宗國覆芳服切
若使子率子必辭王將使我子張病之	子張輙也
王問於子洩	子洩不狃洩息列切又作泄
對曰魯雖無與立	緩時若無能自立
必有與斃	急則人人知懼皆將同死戰斃婢丗切
諸侯將救之未可以得志焉晉與齊楚輔之是四讎也	與魯而四
夫魯齊晉之脣脣亡齒寒君所知也不救何爲三月呉伐我子洩率故道險從武城	故由險道欲使魯成備釋文子洩率絶句故道險絶句
初武城人或有因於呉竟田焉	僑田呉界竟音境僑其驕切
拘鄫人之漚菅者曰何故使吾水滋	鄫人亦僑田呉滋濁也拘音俱漚烏豆切管古顔切滋音玄本亦作兹子絲切字林云黒也
及呉師至拘者道之以伐武城克之	鄫人敎呉必可克道音導
王犯甞爲之宰澹臺子羽之父好焉國人懼	王犯呉大夫故甞奔魯爲武城宰澹臺子羽武城人孔子弟子也其父與王犯相善國人懼其爲内應澹待甘切應應對之應
懿子謂景伯若之何對曰呉師來斯與之戰何患焉且召之而至又何求焉	言犯盟伐邾所以召呉
呉師克東陽而進舍於五梧明日舎於𧖟室	二邑魯地
公賔庚公甲叔子與戰于夷獲叔子與析朱鉏	公賔庚公甲叔子并析朱鉏爲三人皆同車傳互言之析星曆切
獻於王王曰此同車必使能國未可望也	同車能俱死是國能使人故不可望得
明日舎于庚宗遂次於泗上微虎欲宵攻王舎	微虎魯大夫泗音四
私屬徒七百人三踊於幕庭	於悵前設格令士試躍之篇音燭幕亡博切格更百切令力呈切躍羊灼切
卒三百人有若與焉	卒終也終得三百人任行有若孔子弟子與在三百人中與音預任音壬
及稷門之内	三百人行至稷門
或謂季孫曰不足以害呉而多殺國士不如巳也乃止之呉子聞之一夕三遷	畏微虎三息暫切
呉人行成	求與魯成
將盟景伯曰楚人圍宋易子而食析骸而爨	在宣十五年骸戸皆切本又作骨爨七亂切
猶無城下之盟我未及虧而有城下之盟是棄國也呉輕而逺不能乆將歸矣請少待之弗從景伯負載造於萊門	以言不見從故負載書將欲出盟虧去危切輕遣政切載如字或音戴造七報切萊音來
乃請釋子服何於呉呉人許之以王子姑曹當之而後止	釋舎也魯人不以盟爲了欲因留景伯爲質於呉旣得呉之許復求呉王之子以交質呉人不欲留王子故遂兩止質音致復扶又切
呉人盟而還	不書盟恥吳夷
○齊悼公之來也	在五年
季康子以其妹妻之即位而逆之季魴侯通焉	魴侯康子叔父妻七計切魴音房
女言其情弗敢與也齊侯怒夏五月齊鮑牧帥師伐我取讙及闡○或譛胡姬於齊侯	胡姬景公妾
曰安孺子之黨也六月齊侯殺胡姬	傳言齊侯無道所以不終
○齊侯使如呉請師將以伐我乃歸邾子	齊未得季姬故請師也呉前爲邾討魯懼二國同心故歸邾子爲于僞切
邾子又無道呉子使大宰子餘討之	子餘大宰嚭
囚諸樓臺栫之以棘	栫雍也栫本又作荐在薦切雍於勇切
使諸大夫奉大子革以爲政	革邾大子桓公也爲十年邾子來奔傳
○秋及齊平九月臧賔如如齊涖盟	賔如臧㑹子
齊閭丘明來涖盟	明閭丘嬰之子也盟不書諱略之
且逆季姬以歸嬖	季姬魴侯所通者
○鮑牧又謂羣公子曰使女有馬千乗乎	有馬千乗使為君也鮑牧本不欲立陽生故諷動羣公子女音汝乗繩證切諷方鳯切
公子愬之公謂鮑子或譛子子姑居於潞以察之	路齊邑愬音素潞音路
若有之則分室以行若無之則反子之所出門使以三分之一行半道使以二乗及潞麇之以入遂殺之	麇亦束縛麇丘隕切
○冬十二月齊人歸讙及闡季姬嬖故也經九年春王二月葬杞僖公	無傳三月而葬速
○宋皇瑗帥師取鄭師于雍丘	書取覆而敗之雍丘縣屬陳留雍於勇切
○夏楚人伐陳○秋宋公伐鄭○冬十月傳九年春齊侯使公孟綽辭師于呉	齊與魯平故辭呉師綽昌灼切本又作卓同
呉子曰昔歳寡人聞命今又革之不知所從將進受命於君	爲十年呉伐齊傳
○鄭武子䞉之嬖許瑕求邑無以與之	賸罕達也殺武子之屬賸以證切
請外取許之	瑕請取於他國
故圍宋雍丘宋皇瑗圍鄭師	許瑕師
毎日遷舎	作壘塹成輒徒舎合其圍壘力軌切塹七豔切
壘合鄭師哭子姚救之大敗	子姚武子賸也
二月甲戌宋取鄭師子雍丘使有能者無死	惜其能也
以郟張與鄭羅歸	鄭之有能者郟古洽切又音甲
○夏楚人伐陳陳即呉故也○宋公伐鄭	報雍丘
○秋呉城䢴溝通江淮	於䢴江築城穿溝東北通射陽湖西北至末口入淮通糧道也今廣陵韓江是䢴音寒射食亦切又音亦
○晉趙鞅卜救鄭遇水適火	水火之兆
占諸史趙史墨史龜	皆晉史
史龜曰是謂沈陽	火陽得水故沈
可以興兵	兵隂類也故可以興兵
利以伐姜不利子商	姜齊姓子商謂宋
伐齊則可敵宋不吉史墨曰盈水名也子水位也	趙鞅姓盈宋姓子水盈坎乃行子姓又得北方水位
名位敵不可干也	二水俱盛言不可干
故炎帝爲火師	神農有火瑞以火名官
姜姓其後也水勝火伐姜則可史趙曰是謂如川之滿不可游也	旣盈而得水位故爲如川之滿不可馮游言其波流成㳺音由馮皮氷切
鄭方有罪不可救也	鄭以嬖寵伐人故以爲有罪
救鄭則不吉不知其他	救鄭則當伐宋故不吉也
陽虎以周易筮之遇泰䷊	乾下坤上泰
之需䷄	乾下坎上需泰六五變需音須
曰宋方吉不可與也	不可與戰泰六五曰帝乙歸妹以祉元吉帝乙紂父五爲天子故稱帝乙隂而得中有似王者嫁妹得如其願受福禄而大吉祉音恥
微子啓帝乙之元子也宋鄭甥舅也	宋鄭爲昏姻甥舅之國宋爲微子之後今卜得帝乙之卦故以爲宋吉
祉禄也若帝乙之元子歸妹而有吉禄我安得吉焉乃止	吉在彼則我伐之爲不吉
○冬呉子使來儆師伐齊	前年齊與呉謀伐魯齊旣與魯成而止故呉恨之反與魯伐齊儆音景
經十年春王二月○邾子益來奔○公㑹呉伐齊	書㑹從不與謀與音預
○三月戊戌齊侯陽生卒	以疾赴故不書弑弑申志切
○夏宋人伐鄭	無傳
○晉趙鞅帥師侵齊○五月公至自伐齊	無傳
○葬齊悼公	無傳
○衛公孟彄自齊歸于衛	無傳書歸齊納之彄苦侯切
○薛伯夷卒	無傳赴以名故書
○秋葬薛惠公	無傳
○冬楚公子結帥師伐陳○呉救陳	季子不書陳人來告不以名
傳十年春邾隱公來奔齊甥也故遂奔齊	終子貢之言
○公㑹呉子邾子郯子伐齊南鄙師于鄎	鄎齊地邾郯不書兵并屬呉不列於諸侯郯音談鄎音息注同并必政切
齊人弑悼公赴于師	以說呉弑申志切
呉子三日哭于軍門之外徐承師舟師將自海入齊齊人敗之呉師乃還	承呉大夫
○夏趙鞅帥師伐齊	經書侵以侵告
大夫請卜之趙孟曰吾卜於此起兵	謂往歳卜伐宋不吉利以伐姜故今興兵
事不再令	再令瀆也
卜不襲吉	襲重也重直龍切又直用切
行也於是乎取犂及轅	犂一名隰濟南有隰隂縣祝阿縣西有轅城犂力兮切又力之切轅音袁又于眷切隰音習本或作濕音同
毀髙唐之郭侵及頼而還○秋呉子使來復儆師	伐齊未得志故爲明年呉伐齊傳復扶又切
○冬公子期伐陳	陳即呉故
呉延州來季子救陳謂子期曰二君不務德	二君呉楚
而力爭諸侯民何罪焉我請退以爲子名務德而安民乃還	季子呉王壽夢少子也壽夢以襄十二年卒至今十千七歳壽夢卒季子巳能讓國年當十五六至今蓋九十餘夢音蒙少詩照切
經十有一年春齊國書帥師伐我○夏陳轅頗出奔鄭	書名貪也頗破可切又普河切
○五月公㑹呉伐齊○甲戌齊國書帥師及呉戰于艾陵齊師敗績獲齊國書	公與伐而不與戰艾陵齊地女五蓋切與音預
○秋七月辛酉滕子虞母卒	無傳赴以名故書之
○冬十有一月葬滕隱公	無傳
○衛丗叔齊出奔宋	書名淫也
傳十一年春齊爲鄎故	鄎在前年爲于僞切
國書髙無㔻帥師伐我及清	清濟地濟北盧縣東有清亭㔻普悲切
季孫謂其宰冉求	冉求魯人孔子弟子
曰齊師在清必魯故也若之何求曰一子守二子從公禦諸竟季孫曰不能	自度力不能使二子禦諸竟守手又切從才用切禦魚吕切亦作御竟音境度待洛切
求曰居封疆之間	封疆竟内近郊之地疆居良切
季孫告二子	二子叔孫孟孫也
二子不可求曰若不可則君無岀一子帥師背城而戰不屬者非魯人也	屬臣屬也言不戰爲不臣
魯之羣室衆於齊之兵車	羣室都邑居家
一室敵車優矣子何患焉二子之不欲戰也冝政在季氏	言二子恨季氏專政故不盡力釋文二子之不欲戰也冝絶句
當子之身齊人伐魯而不能戰子之恥也大不列於諸侯矣季孫使從於朝	使冉求隨已之公朝
俟於黨氏之溝	黨氏溝朝中地名黨音掌
武叔呼而問戰焉	問冉求
對曰君子有逺慮小人何知懿子彊問之對曰小人慮材而言量力而共者也	言子所問非已材力所及故不能言彊其丈切共音恭
武叔曰是謂我不成丈夫也	知冉求非已不欲戰故不對不成丈夫也本或作大夫非
退而蒐乗	蒐閱蒐所求切乗繩證切閱音恱
孟孺子洩帥右師	孺子孟懿子之子武伯彘孺而住切彘直材切
顔羽御邴洩爲右	二子孟氏臣邴音丙又彼命切
冉求帥左師管周人御樊遟爲右	樊遟魯人孔子弟子樊須父音甫
季孫曰須也弱有子曰就用命焉	雖年少能用命有子冉求也少詩照切
季氏之甲七千冉有以武城人三百爲已徒卒	歩卒精兵卒子忽切
老幼守宫次于雩門之外	南城門也雩音于
五日右師從之	五日乃從言不欲戰
公叔務人	務人公爲昭公子
見保者而泣	保守城者
曰事充	繇役煩繇本亦作徭同音遥
政重	賦務多
上不能謀士不能死何以治民吾旣言之矣敢不勉乎	旣言人不能死已不敢不死
師及齊師戰于郊齊師自稷曲	稷曲郊地名
師不踰溝樊遟曰非不能也不信子也請三刻而踰之	與衆三刻約信
如之衆從之	如樊遟言乃踰溝
師入齊軍	冉求之師
右師奔齊人從之	逐右師
陳瓘陳莊渉泗	二陳齊大夫瓘古喚切泗音四
孟之側後入以爲殿	之側孟氏族也子反殿丁練切
抽矢䇿其馬曰馬不進也	不欲伐善抽勑留切䇿初革切本或作筴
林不狃之伍曰走乎	不狃魯士五人爲伍敗而欲走
不狃曰誰不如	我不如誰而欲走如如字又而庶切
曰然則止乎不狃曰惡賢	言止戰惡足爲賢皆無戰志惡音烏
徐歩而死	徐行而死言魯非狃壯士俱季孫不能使
師獲甲首八十	冉求所得
齊人不能師	不能整其師
宵諜曰齊人遁	諜間也諜音牒遁徒困切間間廁之間
冉有請從之三季孫弗許孟孺子語人曰我不如顔羽而賢於邴洩	三子與孟孺子同車語魚據切
子羽銳敏	子羽顔羽銳精也敏疾也言欲戰
我不欲戰而能黙	心雖不欲口不言奔黙本亦作嘿亡北切
洩曰驅之	言驅馬欲奔
公爲與其嬖僮汪錡乗皆死皆殯	皆俱也嬖必計切僮本亦作童音同江烏黃切錡魚綺切乗繩證切
孔子曰能執干戈以衛社稷可無殤也	時人疑童子當殤殤音商八歳至十九歳爲殤
冉有用矛於齊師故能入其軍孔子曰義也	言能以義勇不書戰不皆陳也不書敗勝負不殊矛亡侯切陳直覲切
○夏陳轅頗出奔鄭初轅頗爲司徒賦封田以嫁公女	封内之田悉賦稅之
有餘以爲己大器	大器鍾鼎之屬
國人逐之故出道渴其族轅咺進稻醴梁糗腵脯焉	糗乾飯也咺況阮切醴音禮以稻米爲醴酒糗起九切以梁米爲之又昌紹切腵丁亂切字亦作銀如薑桂日脯也
喜曰何其給也對曰器成而具	具此醴糗
曰何不吾諫對曰懼先行	恐言不從先見逐
○爲郊戰故公㑹呉子伐齊	欲以報也爲于僞切
五月克博壬申至于嬴	博嬴齊邑也一縣皆屬泰山嬴音盈
中軍從王	呉中軍
胥門巢將上軍王子姑曹將下軍展如將右軍	三將呉大夫
齊國書將中軍髙無㔻將上軍宗樓將下軍陳僖子謂其弟書爾死我必得志	書子占也欲獲死事之功
宗子陽與閭丘明相厲也	相對厲至死子陽宗樓也
桑掩胥御國子	國子國書
公孫夏曰二子必死	亦勸勉之夏戸稚切
將戰公孫夏命其徒歌虞殯	虞殯送葬歌曲示必死殯必刃切
陳子行命其徒具含玉	子行陳逆也具含玉亦示必死行如字又戸郎切含戸暗切本又作唅
公孫揮命其徒曰人尋約呉髮短	約繩也八尺爲尋呉髪短欲以繩貫其首揮許韋切
東郭書曰三戰必死於此三矣	三戰夷儀五氏與今
使問弦多以琴	弦多齊人也六年奔魯問遺也遺唯季切
曰吾不復見子矣	言將死戰
陳書曰此行也吾聞鼔而巳不聞金矣	鼔以進軍金以退軍不聞金言將死也傳言呉師疆齊人皆自知將敗
甲戌戰于艾陵展如敗髙子	齊上軍敗
國子敗胥門巢	呉上軍亦敗
王卒助之大敗齊師獲國書公孫夏閭丘明陳書東郭書革車八百乗甲首三千以獻于公	公以兵從故以勞公卒子忽切乗䋲證切從才用切又如字勞力報切
將戰呉子呼叔孫	叔孫武叔州仇
曰而事何也	問何職
對曰從司馬	從呉司馬所命
王賜之甲劒鈹曰奉爾君事敬無廢命叔孫未能對衛賜進	賜子貢孔子弟子鈹普悲切
曰州仇奉甲從君而拜	拜受之
公使大史固歸國子之元	歸於齊也元首也呉以獻魯
寘之新篋褽之以玄纁	褽薦也寘之䜴切篋苦協切褽音尉或作褽以玄纁纁許云切本亦作勲
加組帶焉寘書于其上曰天若不識不衷何以使下國	言天識不善故殺國子組音祖衷音忠
呉將伐齊越子率其衆以朝焉王及列士皆有饋賂呉人皆喜唯子胥懼曰是豢呉也夫	豢養也若人養犧徃非愛之將殺之饋其位切或作餽賂音路豢音患夫音扶
諫曰越在我心腹之疾也壤地同而有欲於我	欲得呉
夫其柔服求濟其欲也不如早從事焉	從事擊之
得志於齊猶獲石田也無所用之	石田不可耕
越不爲沼呉其泯矣使醫除疾而曰必遺類焉者未之有也盤庚之誥曰其有顚越不共則劓殄無遺育無俾易種于兹邑	盤庚商書也顚越不共從橫不承命者也劓割也殄絶也育長也俾使也易種轉生種類沼之兆切泯亡軫切盤歩干切誥古報切共音恭注同劓魚器切殄大典切俾必耳切種章勇切從子容切長丁丈切
是商所以興也今君易之將以求大不亦難乎弗聽使於齊屬其子於鮑氏爲王孫氏	私使人至齊屬其子改姓爲王孫欲以辟呉禍使所吏切屬音燭下同
反役王聞之使賜之屬鏤以死	艾陵役也屬鏤劒名鏤力俱切又力侯切
將死曰樹吾墓檟檟可材也呉其亡乎三年其始弱矣盈必毀天之道也	越人朝之伐齊勝之盈之極也爲十三年越伐呉起檟古雅切木名
○秋季孫命脩守備曰小勝大禍也齊至無曰矣	善有備守手又切
○冬衛大叔疾出奔宋	疾即齊也
初疾娶于宋子朝	子朝宋人仕衛爲大夫朝如字
其娣嬖	娣所娶女之娣
子朝出	出奔
孔文子使疾出其妻而妻之疾使侍人誘其初妻之娣寘於犂	犂衛邑妻七計切犂力兮切
而爲之一宫如二妻文子怒欲攻之仲尼止之遂奪其妻或淫于外州外州人奪之軒以獻	外州衛邑軒車也以獻於君
恥是二者故出衛人立遺使室孔姞	遺疾之弟孔姞孔文子之女疾之妻姞其乙切又其吉切
疾臣向魋	爲宋向魋臣魋徒囬切
納美珠焉與之城鉏	城鉏宋邑
宋公求珠魋不與由是得罪及桓氏出	出在十四年
城鉏人攻大叔疾衛莊公復之	聽使還
使處巢死焉殯於鄖葬於少禘	終言疾之失所也巢鄖少禘皆衛地鄖音云少詩照切禘大計切
初晉悼公子憖亡在衛使其女僕而田	僕御田獵憖魚覲切一作整征領切
大叔懿子止而飲之酒	㦤子大叔儀之孫飲於鴆切
遂聘之生悼子	悼子大叔疾聘匹政切
悼子即位故夏戊爲大夫	夏戊悼子之甥夏戸雅切戊音茂
悼子亡衛人翦夏戊	翦削其爵邑
孔文子之將攻大叔也訪於仲尼仲尼曰胡簋之事則甞學之矣	胡簋禮器名夏曰胡周曰簋簋音軌
甲兵之事未之聞也退命駕而行曰鳥則擇木木豈能擇鳥	以鳥自喻
文子遽止之曰圉豈敢度其私訪衛國之難也	圍文子名度謀也遽其據切度待洛切下同難乃旦切
將止	仲尼止
魯人以幣召之乃歸	於是自衛反魯樂正雅頌各得其所
○季孫欲以田賦	丘賦之法因其田財通出馬一疋牛三頭今欲別其田及家時各爲一賦故言田賦别如字又彼列切
使冉有訪諸仲尼仲尼曰丘不識也三發	三發問
卒曰	卒終也
子爲國老待子而行若之何子之不言也仲尼不對	不公荅
而私於冉有曰君子之行也	行政事
度於禮施取其厚事舉其中斂從其薄如是則以丘亦足矣	丘十六井出戎馬一疋牛三頭是賦之常法施尸䜴切斂力豔切
若不度於禮而貪冒無厭則雖以田賦將又不足且子季孫若欲行而法則周公之典在若欲苟而行又何訪焉弗聽	爲明年用田賦傳冒亡北切又莫報切厭於鹽切
經十有二年春用田賦	直書之者以示改法重賦
○夏五月甲辰孟子卒	魯人諱娶同姓謂之孟子春秋不改所以順時娶本或作取七喻切又如字
○公㑹呉于橐臯	橐臯在淮南逡遒縣東南槖章夜切一音託逡音峻又七倫切道音囚又音廵
○秋公㑹衛侯宋皇瑗于鄖	鄖發陽也廣陵海陵縣東南有發繇口繇音遥
○宋向巢帥師伐鄭○冬十有二月螽	周十二月今十月是歳置閏而失不置雖書十二月實今之九月司歷誤一月九月之初尚温故得有螽螽音終
傳十二年春王正月用田賦	終前年事
○夏五月昭夫人孟子卒昭公娶于呉故不書姓	諱娶同姓故謂之孟子若宋女
死不赴故不稱夫人	不稱夫人故不言薨
不反哭故不言葬小君	反哭者夫人禮也以同姓故不成其夫人喪
孔子與弔適季氏季氏不絻放絰而拜	孔子始老故與弔也絻喪冠也孔子以小君禮往弔季孫不服喪故去絰從主節制與音預絻音問絰大結切去起吕切
○公㑹呉于橐臯呉子使太宰嚭請尋盟	尋鄫盟
公不欲使子貢對曰盟所以周信也	周固
故心以制之	制其義
玉帛以奉之	奉贄明神贄音至
言以結之	結其信
明神以要之	要以禍福要一還切
寡君以爲苟有盟焉弗可改也巳若猶可改日盟何益今吾子曰必尋盟若可尋也亦可寒也	尋重也寒歇也重直龍切歇許謁切
乃不尋盟○呉徴㑹于衛初衛人殺呉行人且姚而懼謀於行人子羽	子羽衛大夫且子餘切
子羽曰呉方無道無乃辱吾君不如止也子木曰呉方無道	子木衛大夫
國無道必棄疾於人呉雖無道猶足以患衛	爲衛患也
往也長木之斃無不摽也	摽擊斃婢丗切摽敷蕭切又普交切
國狗之瘈無不噬也	瘈狂也噬齧也狗音苟瘈吉丗切噬市制切齧五結切或作嚙
而況大國乎秋衛侯㑹呉于鄖公及衛侯宋皇瑗盟	盟不書畏呉竊盟
而卒辭呉盟呉人藩衛侯之舎	藩籬藩方元切籬力知切
子服景伯謂子貢曰夫諸侯之㑹事旣畢矣侯伯致禮地主歸餼	侯伯致禮以禮賔也地主所㑹主人也餼生物餼許氣切
以相辭也	各以禮相辭讓
今呉不行禮於衛而藩其君舎以難之	難苦困也難乃且切
子盍見大宰乃請束錦以行	以賂呉盍戸臘切
語及衛故	若本不爲衛請者爲于僞切
大宰嚭曰寡君願事衛君衛君之來也緩寡君懼故將止之	止執
子貢曰衛君之來必謀於其衆其衆或欲或否是以緩來其欲來者子之黨也其不欲來者子之讎也若執衛君是墮黨而崇讎也	墮毀也墮許規切下同
夫墮子者得其志矣且合諸侯而執衛君誰敢不懼墮黨崇讎而懼諸侯或者難以霸乎大宰嚭說乃舎衛侯衛侯歸效夷言子之尚幼	子之公孫彌牟說音恱下同舎音捨釋也又音赦效戸敎切
曰君必不免其死於夷乎執焉而又說其言從之固矣	出公輒後卒死於越
○冬十二月螽季孫問諸仲尼仲尼曰丘聞之火伏而後蟄者畢	火心星也火伏在今十月蟄直立切
今火猶西流司歷過也	猶西流言未盡没如是九月歷官失一閏釋例論之備
○宋鄭之間有隙地焉	隙地間田隙去逆切間音閑一本作間地又如字
曰彌作頃丘玉暢嵒戈錫	凡六邑彌亡支切又亡爾切頃苦潁切又音傾暢勑亮切一本作壬暢嵒五咸切戈古禾切錫音羊又星歷切
子産與宋人爲成曰勿有是	俱棄之
及宋平元之族自蕭奔鄭	在定十五年
鄭人爲之城嵒戈錫	城以處平元之族爲于僞切
九月宋向巢伐鄭取錫殺元公之孫遂圍嵒十二月鄭罕達救嵒丙申圍宋師	此事經在十二月螽上今倒在下更具列其月以爲别者丘明本不以爲義例故不皆齊同别如字又彼列切
經十有三年春鄭罕達帥師取宋師于嵒	書取覆而敗之
○夏許男成卒	無傳成音城本或作戍
○公㑹晉侯及呉子于黃池	陳留卦丘縣南有黄亭近濟水夫差欲霸中國尊天子自去其僭號而稱子以告今諸侯故吏承而書之近附近之近去起吕切僭子念切
○楚公子申帥師伐陳	無傳
○於越入呉○秋公至自㑹	無傳
○晉魏曼多帥師侵衛	無傳
○葬許元公	無傳
○九月螽	無傳書災
○冬十有一月有星孛于東方	無傳平且衆星皆没而孛乃見故不言所在之次孛歩内切見賢遍切
○盗殺陳夏區夫	無傳稱盗非大夫夏戸侯切區烏侯切
○十有二月螽	無傳前年季孫雖聞仲尼之言而不正歷失閏至此年故復十二月螽實十一月復扶又切
傳十三年春宋向魋救其師	救前年國嵒師
鄭子賸使徇曰得桓魋者有賞魋也逃歸遂取宋師于嵒獲成讙郜延	二子宋大夫讙火官切郜古報切又古毒切
以六邑爲虚	空虚之名不有虚如字或音墟非
○夏公㑹單平公晉定公呉夫差于黃池	平公周卿士也不書尊之不與㑹單音善與音預
○六月丙子越子伐呉爲二隧	隧道也隧音遂
疇無餘謳陽自南方	二子越大夫謳烏侯切
先及郊呉大子友王子地王孫彌庸壽於姚自泓上觀之	觀越師泓水名泓烏宏切
彌庸見姑蔑之旗	姑蔑越地今東陽大末縣蔑亡結切旗音其大音泰孟康云大音闥
曰吾父之旗也	彌庸父爲越所獲故姑蔑人得其旌旗
不可以見讎而弗殺也大子曰戰而不克將亡國請待之彌庸不可屬徒五十	屬㑹也屬音燭
王子地助之乙酉戰彌庸獲疇無餘地獲謳陽越子至王子地守丙戌復戰大敗呉師獲大子友王孫彌庸壽於姚	地守故不獲守手又切復抶又切
丁亥入呉呉人告敗于王王惡其聞也	惡諸侯聞之惡烏路切
自剄七人於幕下	以絶口剄古項切
○秋七月辛丑盟呉晉爭先	爭㰱血先後㰱所洽切又所甲切
呉人曰於周室我爲長	呉爲大伯後故爲長長丁丈切大音泰
晉人曰於姬姓我爲伯	爲侯伯
趙鞅呼司馬寅	寅晉大夫
曰日旰矣	旰晚矣旰古旦切
大事未成二臣之罪也	太事盟也二臣鞅與寅
建鼓整列二臣死之長幼必可知也對曰請姑視之反曰肉食者無墨	墨氣色下
今呉王有墨國勝乎	國爲敵所勝
大子死乎且夷德輕不忍乆請少待之	少待無與爭輕遣政切
乃先晉人	盟不書諸侯恥之故不録
呉人將以公見晉侯子服景伯對使者曰王合諸侯則伯帥侯牧以見於王	伯王官伯侯牧方伯上見如字又賢遍切使所吏切下見賢遍切
伯合諸侯則侯帥子男以見於伯	伯諸侯長
自王以下朝聘玉帛不同故敝邑之職貢於呉有豐於晉無不及焉以爲伯也今諸侯㑹而君將以寡君見晉君則晉成爲伯矣敝邑將改職貢魯賦於呉八百乗若爲子男則將半邾以屬於呉	半邾三百乗豐芳中切乗繩證切下同
而如邾以事晉	如邾六百乗
且執事以伯召諸侯而以侯終之何利之有焉呉人乃止旣而悔之	謂景伯欺之
將囚景伯景伯曰何也立後於魯矣	何景伯名
將以二乗與六人從遟速唯命遂囚以還及戸	戸牖陳留外黄縣西北東皆城是從才用切牖音酉
謂大宰曰魯將以十月上辛有事於上帝先王季辛而畢何丗有職焉	有職於祭事
自襄以來未之改也	魯襄公
若不㑹祝宗將曰呉實然	言魯祝宗將告神云景伯不㑹坐爲呉所囚呉人信鬼故以是恐之坐才卧切恐丘勇切
且謂魯不共而執其賤者七人何損焉大宰嚭言於王曰無損於魯而祗爲名	適爲惡名共音恭祗音支
不如歸之乃歸景伯呉申叔儀乞糧於公孫有山氏	申叔儀呉大夫公孫有山魯大夫舊相識
曰佩玉橤兮余無所繫之	繠然服飾備也已獨無以繫佩言呉王不恤下繠而捶切又而水切
旨酒一盛兮余與褐之父睨之	一盛一器也睨視也褐寒賤之人言但得視不得飲盛音成又市政切褐戸葛切父音甫睨五計切
對曰梁則無矣麤則有之若登首山以呼曰庚癸乎則諾	軍中不得出糧故爲私隱庚西方主榖癸北方主水傳言呉子不與士共飢渴所以亡麤七奴切呼火故切
王欲伐宋殺其丈夫而囚其婦人	以宋不㑹黃池故言呉人悖惑文直兩切本或作大夫誤悖𥙷内切
人宰嚭曰可勝也而弗能居也乃歸○冬呉及越平	終伍貟之言
春	_
秋	_
左	_
氏	_
傳	_
卷	_
第	_
二	_
十	_
九	_
