特牲饋食禮第十五	鄭云諸侯之士以歲時祭其祖庿之禮	source
不諏	子須反謀也	source
職䙝	息列反	_
為詛	莊助反	_
來與	音預	commentary
闑西	魚列反	commentary
閾外	于逼反又況逼反	commentary
為筮	于偽反下為神為視皆同	_
作槷	魚列反	commentary
作蹙	子六反	commentary
西塾	音孰	commentary
謂蓍	音尸	_
之長	丁丈反下長占并注同	commentary
言妃	音配又芳非反	commentary
禫月	大感反	source
還即	音環	_
由便	婢靣反後放此	commentary
畫地	音獲	source
其馮	音憑	commentary
主人辟	劉芳益反一音避	commentary
傳命	丈專反下同	commentary
將涖	音利又音類	commentary
有鼏	亡狄反	commentary
棜在	於庶反	source
從也	子容反	source
木轝	音預	source
鈃	音刑	_
兩敦	音對劉又都愛反後放此	commentary
當夾	古洽反劉古協反後皆同	source
近南	附近之近下同	source
兄弟從	如字又才用反後以意求之	source
濯漑	古愛反	source
省文	所景反下文省同	source
以筴	初革反	_
羮飪	而甚反	source
視饎	尺志反注糦同	commentary
齊坫	丁念反	_
亨于	普庚反注及下注不能亨亨者同	source
以鑊	戸郭反	commentary
漑之	古愛反	commentary
釡鬵	音尋劉側林反	commentary
藉用	慈夜反	commentary
萑	音完細葦也	commentary
細葦	于鬼反	source
尸盥	音管	source
匜	音移	source
簞	音丹	commentary
不揮	許韋反	commentary
凡郷	許亮反下同	commentary
敷席	音孚本又作鋪普吳反後同	source
纚	所買反又所綺反	source
宵	音消依字作綃綺屬	source
猶辦	皮莧反	source
少牢	詩召反下少牢皆同	source
蝸醢	力禾反	commentary
直室	音值	commentary
賔長	丁丈反下注庭長下賔長弟長并注放此	source
用鮒	音附	source
爲其	于僞反下當爲不爲爲將爲改同	source
道之	音導下以道猶道同	_
旣錯	七故反下文及注同	commentary
朼載	必履反	_
刊其	若干反	_
惡桑	烏路反	commentary
抽扃	古熒反	source
東枋	音柄本亦作柄下同	_
升肵	音祈	commentary
鈃芼	亡報反	_
啓㑹	古外反下并下注於㑹同	commentary
祝曰	州又反下文卒祝祝曰同	commentary
普淖	女孝反	commentary
爲厭	一葉反	commentary
詔侑	音又	commentary
武方	音無	commentary
妥尸	他果反劉湯回反	source
彊之	其丈反	_
挼祭	依注音墮許恚反劉相恚反後隋祭挼祭皆放此	commentary
㨎醢	如恱反劉而玄反又而誰反後同	commentary
啐酒	七内反	commentary
刌肺	寸本反	commentary
齊敬	側皆反	commentary
共之	音恭	commentary
菜和	戸臥反下不和同	commentary
客絮	丑慮反調和之也	source
湆	去及反	source
不嚌	才計反	commentary
先食	悉薦反又如字	source
啗之	大敢反	commentary
三飯	扶晩反注及下同	commentary
膮	許堯反	commentary
炙	章夜反下肝炙同	commentary
胾醢	莊吏反	commentary
得䋫	側耕反	source
舉骼	音格又音各後皆同	commentary
不復	扶又反下爲復復拜不復并復入同	commentary
者三	息暫反	commentary
盛肵	音成注同	commentary
三个	古賀反注干個同	commentary
及臑	乃報反	commentary
酳	以刃反又士刃反	source
樂之	音洛	commentary
下大	戸嫁反下下尸同	source
以醋	才各反	commentary
聽嘏	古雅反受福曰嘏嘏長也大也	commentary
摶黍	大官反	commentary
挂于	俱賣反一音卦注同	commentary
奉納	芳勇反	source
季少	詩召反下同下少年之少亦放此	_
以燔	音煩	commentary
爲主	于僞反下爲絶爲異爲將爲酬必爲同	source
不提	丁禮反	commentary
染汚	而漸反	_
襲處	昌慮反	commentary
之別	彼列反	_
之與	音餘下爲之與燕飲與同	commentary
位辯	音遍後皆同	source
加勺	時灼反	source
郷賔	許亮反	commentary
獻長	丁丈反注下皆同	commentary
薦脀	之丞反	commentary
殺也	所界反下皆同	source
將傳	丈專反	commentary
孝弟	音悌	source
定好	呼報反	commentary
洗散	悉但反下皆同	source
猶養	羊亮反下同	source
供養	九用反	source
尸謖	所六反起也	commentary
爲將餕	于僞反下同	commentary
去之	起吕反	source
奠然	本或作暮或作𧃊	source
食𧃊	劉子峻反與餕同	source
有以	依注音似或如字	commentary
言女	音汝下同	source
其坐	才臥反	commentary
親昵	女乙反	_
厞用	扶未反	source
厭	一豔反	source
飫	於庶反	commentary
朝服	直遙反下皆同	commentary
韠	音畢	source
齊服	側皆反	commentary
順從	子容反下南從從橫同	source
饌于	扶轉反又如字	source
覆兩	芳伏反注同	commentary
盝	音鹿	commentary
瀝	音歷	commentary
且爲	于僞反下爲婦爲餕爲尸爲其同	commentary
裹之	音果	_
玄被	皮義反	commentary
若薇	音微	commentary
冬荁	音丸	_
苦荼	音徒	commentary
堇屬	音謹	commentary
膴膴	亡甫反	commentary
如飴	以之反	source
爲芐	音戸劉又音下	source
西辟	步曆反又音壁	_
直屋	音值	commentary
梠	音侣	source
皆去	起吕反	commentary
近南	附近之近	commentary
奉槃	芳勇反	commentary
淳沃	之純反劉音純	commentary
作激	古狄反一本作浮劉本作徼音敷	commentary
辟位	婢亦反又音避注同	commentary
逡	七旬反	source
遁	音旬	commentary
弟婦	大計反或作娣下弟同	_
姒婦	音似本或作似	commentary
燔燎	力召反或力弔反	commentary
肫	時倫反又之春反又之罪反	source
有併	步頂反	commentary
放而	方往反	commentary
數奇	居冝反下同	_
猶㨒	苦圭反	source
不提	丁禮反	commentary
髀	步禮反又方爾反	source
脡	他頂反	commentary
觳	戸角反又苦角反	commentary
辟大	音避	commentary
長兄	丁丈反注同	source
皆殽	戸交反	commentary
見政	賢遍反又如字	commentary
皆與	音預	commentary