有司第十七	本或作有司徹鄭云大夫旣祭儐尸於堂之禮	source
有司徹	直列反字又作撤	source
以厭	一豔反	commentary
於祊	百庚反	commentary
大庿	音泰下大宰同	_
爲儐	于僞反下爲尸同	_
少儀	詩召反下之少年少同	commentary
汜埽	芳劒反下索到反	_
曰拚	方問反	commentary
爲聶	女輒反	source
燅	音尋劉徐鹽反温也注燖同	commentary
肵亦	音祈	commentary
不與	音預	commentary
扃	古熒反注同	_
鼏	亡狄反	commentary
去其	起吕反下拂去同	commentary
禮殺	所界反劉色例反下皆同	commentary
爲鉉	玄犬反	commentary
侑于	音又	commentary
道尸	音導	commentary
爲蹙	子六反	commentary
並併	步頂反後皆同	source
匕湆	去及反	source
豕脀	之承反	source
長左	丁丈反後皆同	source
麷	芳中反熬麥也	source
蕡	扶云反熬枲也	source
醓	他感反	_
麋臡	乃兮反又人兮反	_
枲也	思治反	_
辟鈃	音避下亦辟辟併辟主同	_
肫	音純	commentary
胳	音格又音各本亦作骼	source
臑	奴到反	source
脡	他頂反	source
復序	扶又反下不復復言同	_
折分	之設反下皆同	_
嚌	才計反	commentary
下尸	户嫁反下注下尸下之亦下下侑下主人下大夫下上大夫同	commentary
而摭	之石反	commentary
加膴	火吳反依注音􁇥況甫反劉呼孤反後同	source
刳魚	口吳反又口侯反	commentary
大臠	力轉反	source
㨎	如帨反劉而誰反	source
執挑	湯堯反劉湯姚反又他羔反一音由又食汝反	_
以挹	一入反	commentary
之歃	初洽反劉初輒反下扱同	commentary
或作挑	本又作抌劉忒羔反	_
飯操	七消反	_
以抒	食汝反	commentary
覆手	芳伏反下同	commentary
啐	七内反	commentary
羊燔	音煩	commentary
由便	婢面反	source
糗	去九反	source
與腶	丁亂反木又作段音同加薑桂以脯而鍛之曰腶脩	_
餌也	音二	source
擣肉	劉本作搗同丁老反	source
爲斷	丁亂反	source
之柶	音四	source
挩手	由銳反注紛帨音同	source
冝郷	許亮反	source
粉餈	在私反	source
則酏	以支反劉書支反	commentary
食	音寺下同	source
糝食	素感反	commentary
臐	許云反	source
膮	許堯反	commentary
有胾	側吏反	source
以辯	音遍注徧同後放此	source
儀度	大各反	source
作􁏆	劉音儀	source
不別	彼列反	_
親昵	女乙反	source
爲衆	于僞反下爲不爲鬼同	commentary
隆汚	音烏	source
延熹	許其反	commentary
不綏	許恚反本亦作隋同	commentary
七飯	扶晚反後皆同	commentary
乃盛	音成注及下同	commentary
無髀	步禮反又方爾反	commentary
三个	古賀反	source
爲揲	之石反劉音與摭同	_
也與	音余	source
酳尸	以刃反又士刃反	commentary
其綏	并注挼及隋皆許惠反後放此	commentary
弟婦	音娣	commentary
觳折	苦角反又戸角反	source
尸謖	所六反	source
乃𧃊	音俊	source
厞	扶味反	commentary
取敦	音對劉又都愛反下同	source
厭	一豔反	commentary
飫	於庶反	source
不令	力呈反	commentary
作茀	音弗	commentary