爲政第二	先學而後從政故爲政次學而也	source
凡二十四章衆星共	求用反鄭作拱俱勇反拱手也	_
猶北辰之不移	本或作譬猶北辰之不移	commentary
蔽	必世反包云當也鄭云塞也	source
猶當	丁浪反又如字	commentary
無邪	似嗟反	commentary
道之	音導下同	_
以德	包云道德也鄭云六德謂智仁聖義中和	_
格	加百反正也鄭云來也	commentary
孫彘	直例反	source
不妄	亡尚反	commentary
能養	羊尚反下及注養人同	_
以別	彼列反注同	_
食	音嗣	source
先生饌	上眷反馬云飲食也鄭作餕音俊食餘曰餕	commentary
曽	音増馬云則皇侃云嘗也	source
女	音汝	_
人焉	於䖍反下同	source
廋	所留反匿也	source
匿也	女力反	commentary
温故	烏門反尋也	source
繹	音亦	commentary
不比	毗志反下同	commentary
則罔	本又作冈	source
則殆	音待依義當作怠	commentary
誨女	音汝後可以意求之	_
知也	如字又音智	source
姓顓	音專	source
寡尤	下求反	commentary
行	下孟反注同	commentary
錯	七路反注同置也鄭本作措投也	commentary
枉	紆枉反	source
邪枉	似嗟反	source
孝于	如字一本作孝乎	_
奚其爲爲政也	一本無一爲字	source
車	音居	commentary
無輗	五兮反轅端橫木以縛軛字林五支反	source
無軏	五忽反又音月轅端上曲勾衡	_
枙	音厄又作軛	commentary
十世可知也	一本作可知乎鄭本作可知	_
於夏	户雅反餘以意求之	commentary
三綱	謂父子夫婦君臣是也	source
五常	謂仁義禮智信	commentary
三統	謂天地人三正	commentary
諂也	勑檢反	_