檀弓第三	檀弓魯人檀大丹反姓也弓名以其善於禮故以名篇	_
卷之二公儀仲子	公儀氏仲子字魯之同姓也其名未聞	_
免焉	音問注同以布廣一寸從項中而前交於額上又卻向後繞於髻	source
乃袒	音但	commentary
舎其	音捨下皆同	commentary
適子	多歷反下皆同	source
何居	音姬下同語助	commentary
孫蔑	亡結反	commentary
孫腯	徐本作遁徒本反又徒遜反	source
立衍	以善反	commentary
爲親	于僞反下爲晉禮爲爲師同	commentary
扎子曰否	絶句	_
左右	徐上音佐下音佑今並如字左右扶持也下同	commentary
就養	以尚反下同	commentary
稱其	尺證反	source
以語	魚據反又如字	source
叔向	香亮反叔向羊舌肸	commentary
之葬	徐才浪反又如字	commentary
請合	如字徐音閤後合葬皆同	commentary
欲文	如字徐音問	commentary
不喪	如字下同徐息浪反下放此	_
子思伋	音急子思名也孔子之孫	commentary
母期	居疑反本又作朞後放此	commentary
道隆	力中反盛也	commentary
道汚	音烏下同殺也	source
殺也	所戒反又所例反下同	commentary
自予	羊許反許也一云我也又音餘	commentary
稽顙	素黨反稽顙觸地無容	commentary
頽乎	徒回反順也	commentary
頎	音懇惻隱之貌又音畿	source
觸	昌欲反	commentary
少孤	詩召反下文同	source
不墳	扶云反	source
不識	式志反又如字	_
常處	昌慮反	_
之度	本又作之數	source
防墓	防地之墓也庾云防衞墓崩	commentary
不應	應對之應	commentary
三	息暫反又如字	commentary
泫然	胡犬反	source
涕	音體	commentary
使者	色吏反下及注同	commentary
醢之	音海	commentary
蒯	苦怪反	commentary
聵	五怪反蒯聵衞靈公之太子出公輒之父莊公也	_
篡輒	初患反輒出公名也	commentary
啗食	本又作啖待敢反	_
以怖	普故反	source
命覆	芳服反注同	commentary
期可	音朞	source
衣衾	音欽	source
以爲極亡	並如字極巳也徐紀力反王以極字絶句亡作忘向下讀孫依鄭作亡而如王分句	commentary
不樂	如字又音岳	commentary
郰	側留反又作鄒	source
梁紇	恨發反徐胡切反又胡没反	commentary
五父	音甫注及下同	commentary
衢	求于反	commentary
亦爲	如字又于僞反	commentary
曼父	音万	commentary
其愼	依注作引羊刄反	_
以輤	七見反	commentary
翣	所甲反	commentary
不相	息亮反注同	source
不緌	本又作綏同耳隹反	commentary
去飾	起吕反	source
陶	大刀反	source
即周	本又作堲同子栗反又音稷注下同何云冶土爲甎四周於冡	_
燒	叔招反	source
折即	之設反管子云左手執燭右手折即即燭頭燼也弟子職其篇名	commentary
棺	音官	source
椁	音郭	source
上梓	音子	source
牆置	在良反	commentary
長殤	丁丈反下式羊反十六至十九爲長殤十二至十五爲中殤八歳至十一爲下殤七歳已下爲無服之殤生未三月不爲殤	commentary
爲正	音征下同又如字	commentary
斂用	力驗反下皆同	_
乗驪	力知反徐郎兮反純黒色馬	source
騋	音來馬七尺巳上爲騋	source
乗翰	字又作鶾胡旦反又音寒白色馬	source
物萌	亡耕反	source
乗騵	音原駵馬白腹	commentary
駵	力求反赤馬黒鬣尾	commentary
用騂	息營反徐呼營反純赤色也一云赤黃色	source
曽參	所金反一音七南反後同	commentary
齊斬	音咨本亦作齊齊衰之字後皆放此	commentary
饘	本又作飦之然反說文云麋也周謂之饘宋衞謂之􁉸	commentary
粥	之六反徐又音育字林云淖糜也	commentary
布幕	本又作幂音莫徐音覓下同	source
縿	音綃徐又音蕭	source
縑也	古謙反	source
綃	音消徐本又作䌃桑堯反	source
僭巳	子念反	_
爲幦	莫歷反	source
孋姬	本又作麗亦作驪同力知反	_
重耳	直龍反注皆同	source
子蓋	依注音盍戸臘反下同何不也	source
蚤卒	音早	source
姬嬖	必計反	commentary
欲弑	本又作煞音試注同徐云字又作嗣音同	commentary
皆惡	烏路反	commentary
突	徒忽反	commentary
傅	音富	source
咎犯	其九反	_
皐落	古刀反	_
子少	詩召反	commentary
多難	乃旦反	source
爲君	于僞反下爲時同	source
雉經	如字徐古定反如雉之自經也	commentary
共世子	音恭本亦作恭注同	_
言行	下孟反	source
而莫	音暮	commentary
爲樂	音洛又音岳	commentary
終無巳夫	音扶絶句本或作巳矣夫	commentary
又復	方目反	commentary
乗丘	繩證反	commentary
年夏	戸嫁反	commentary
縣	音玄卷内皆同	source
賁父	上音奔下音甫人名字皆同	commentary
馬驚敗	一本無驚字	commentary
公隊	直類反	commentary
綏	息隹反	commentary
圉人	魚吕反	commentary
股裏	上音古下音里	commentary
中馬	丁仲反	commentary
誄之	力軌反諡也	source
以上	時掌反	source
隅坐不與成人竝	音並絶句	source
睆	華板反明貌孫炎云睆漆也徐又音刮	commentary
之簀	音責牀笫也	source
與	音餘下同	source
畫	衡賣反	commentary
牀笫	上音床下側吏反	commentary
爲刮	古滑反	commentary
瞿然	紀具反下同	source
曰吁	音虚注同吹氣聲也一音況于反	commentary
憊	皮拜反羸困也	commentary
革矣	紀力反徐又音極急也注同	commentary
請	七領反	source
覬也	音兾	source
斃	音弊	commentary
仆	蒲北反又音赴	commentary
而没	音殁	source
慨	苦愛反	commentary
而廓	苦郭反何云開也	commentary
猶索	所白反	source
邾	音誅	commentary
婁	力俱反或如字邾人呼邾聲曰婁故曰邾婁公羊傳與此記同左氏榖梁俱作邾	source
升陘	音形	commentary
魯僖	許冝反	source
之髽	側瓜反	commentary
臺鮐	上音胡下音台	source
去	羌吕反	commentary
纚	所買反又所綺反黒繒韜	commentary
而紒	音計	commentary
錫衰	上悉歷反下七雷反	source
與	音餘	source
吉笄	音雞	commentary
素緫	音揔	commentary
韜	吐刀反	commentary
閲	音恱	_
爾毋	音無後同	commentary
從從	音揔髙也一音崇又仕江反	commentary
扈扈	音戸廣也大也	commentary
爾女	音汝	commentary
大髙	音泰一音勑佐反下大廣巳猶大大重同	source
蓋榛	側巾反木名又士鄰反	commentary
長尺	直亮反凡度長短曰長皆同此音	commentary
子禫	大感反	commentary
比御	必利反下比及同	commentary
蔑	迷結反	commentary
彈琴	徒丹反	commentary
成笙	音生	commentary
絲屨	音句	commentary
組纓	音祖	commentary
無絇	其俱反	commentary
縞	古老反又古報反	commentary
厭	于甲反	commentary
溺	奴狄反	commentary
弗除	如字徐治慮反	source
大公	音泰注及下注大史公皆同	_
忍離	力智反下相離同	source
曰樂樂	並音岳一讀下五敎反又音洛	commentary
丘首	手又反注同	commentary
期	音基	commentary
名鯉	音里	commentary
誰與	音餘下餘閣也與同	commentary
曰嘻	許其反又於其反悲恨之聲	source
蒼梧	音吾	source
陟	知力反升也	commentary
帝嚳	苦毒反髙辛氏帝也	commentary
騷	素刀反一音簫	commentary
湘夫	音相	commentary
差之	初佳反又初冝反	commentary
嬪也	婢人反	commentary
蓋祔	音父	source
於爨	七亂反	commentary
矯之	居表反	source
謙儉	其檢反	commentary
適室	丁歷反	commentary
而語	魚據反	commentary
澌也	本又音斯音賜下同	source
顓孫	音專	source
相近	附近之近	commentary
易成	以豉反	commentary
之奠	田練反	commentary
餘閣	音各	commentary
􁌛藏	字又作庪同九毁反又居僞反	commentary
街里	音佳	commentary
哭嫂	悉早反注同	commentary
人倡	昌尚反注同	source
踴	音勇	commentary
娣姒	大計反下音似	commentary
縮	所六反從也	commentary
縫	音逢又扶用反下同	commentary
衡	依注音橫華彭反	commentary
從也	子容反	source
解	佳買反	commentary
曰伋	音急	commentary
水漿	子良反	commentary
俯	音甫	commentary
跂	丘䜴反	commentary
爲曽	于僞反	source
不稅	徐他外反注同	commentary
以上	時掌反	commentary
使者	色吏反	commentary
賻	音附	source
賵	芳用反	source
乗馬	繩證反四馬曰乗	_
貸	他代反	_
副	音付	_
何傳	直專反一本作傅音附	_
惡乎	音烏惡乎猶於何也	commentary
別親	彼列反下同	_
夫由	舊音扶皇如字謂丈夫即伯髙	source
見我	如字皇賢遍反	commentary
爲爾	于僞反下注爲其疾爲䙝爲我我爲皆同	commentary
來者	一本作爲爾哭也來者	commentary
之滋	音咨	commentary
不嗜	市志反	source
薑	居良反	commentary
而喪	息浪反下喪眀喪爾明同	_
女何	音汝下同	commentary
洙	音姝	commentary
泗	音四洙泗二水名	commentary
華隂	徐胡化反	commentary
異稱	尺證反	source
罪與	音餘	commentary
離羣	羣朋友也上音利	source
索居	悉各反猶散也下注索居同	commentary
晝	知又反	source
致齊	側皆反	commentary
見齒	賢遍反	source
衰與	七雷反下同後五服之衰皆放此不復音	source
不當	丁浪反注同	source
惡其	烏路反	commentary
精麁	本又作麤七奴反	_
廣狹	音洽	source
不應	應對之應	commentary
䙝	息列反	source
偏倚	於彼反又於寄反	commentary
稅	本又作說同他活反徐又如銳反下及注同	commentary
驂	七南反騑馬曰驂夾服馬也	source
騑	芳非反	commentary
偏頗	破多反	commentary
予郷	本又作嚮許亮反	commentary
而出	如字徐尺遂反	commentary
涕	音體	commentary
施惠	始豉反	commentary
予惡	烏路反	commentary
夫涕	音扶	commentary
識	式志反又音式下及注章識皆同	source
啼呼	火故反	source
饋祥	其位反	commentary
遺也	于季反	source
拱而	恭勇反	commentary
傚孔	本又作效胡教反下同	commentary
之嗜	市志反貪也注同	source
蚤作	音早	commentary
枻	羊世反亦作曳	_
消揺	本又作逍遥	commentary
頽	徒回反	commentary
所放	方兩反	source
委乎	本又作萎同紆危反注同病也	_
殆幾	音祈又音機	commentary
在阼	才故反	commentary
兩楹	音盈	commentary
夾之	本又作挾古洽反下注同	commentary
饋食	如字又音嗣	commentary
疇	直留反	commentary
嚮明	本又作郷同許亮反	_
聽治	直吏反	commentary
正坐	才臥反又如字	commentary
之處	昌慮反	_
置	知吏反	commentary
翣	所甲反	commentary
衣木	於旣反	commentary
如襵	所甲反又所洽反	_
與	音餘	commentary
設披	彼義反	source
綢練	吐刀反韜也徐直留反注同	commentary
設旐	直小反	source
杠	音江竿也	commentary
乗車	繩證反	source
布廣	光浪反凡度廣狹曰廣他皆放此	commentary
幅	方木反	commentary
褚	張吕反	_
幕	音莫褚幕覆棺者	source
蟻	魚綺反蚍蜉也又作蛾	commentary
蚍	避尸反徐扶夷反	commentary
蜉	音浮	commentary
之仇	音求讎也	commentary
寢苫	始占反草也	commentary
枕干	之鴆反	commentary
干楯	本又作盾食允反又音允	_
市朝	直遥反注同	source
銜	音咸	_
而使	色吏反	commentary
爲負	于僞反下爲其負相爲同	commentary
從父	如字徐才用反	commentary
爲魁	苦回反首也	commentary
杓	必遥反又匹遥反	commentary
而陪	歩回反	commentary
皆絰	大結反	commentary
易墓	以豉反注同	source
芟治	所銜反	commentary
塡池	依注音奠徐盧王並如字	commentary
載處	昌慮反下同	commentary
遣奠	弃戰反本或作遷奠非	source
推	昌隹反又吐回反	source
柩	其久反	source
辟	音避下辟賢辟不懷並同	commentary
復升	扶又反	commentary
從者	才用反下同	commentary
禮與	音餘下同	commentary
夫祖	音扶	commentary
飰於	煩晚反	_
牖下	羊久反	commentary
小斂	力驗反禮家凡小斂大斂之字皆同不重岀	commentary
於阼	才故反	commentary
且服也	本或作且服過	commentary
裼裘	星曆反	_
夫夫	上音扶下如字一讀並如字注及下同	commentary
袒括	徒旱反下古活反	commentary
而見	賢遍反注及下同	commentary
予之	羊汝反下同	commentary
和之	音禾或胡臥反下同	source
樂由	音岳又音洛	source
未忘	音亡	commentary
彌	亡卑反	commentary
牟	莫侯反	commentary
爲之	于僞反注爲之重服下爲之服皆同	commentary
廢適	丁歷反下文及注同	commentary
涕洟	上他計反下音夷自目曰涕自鼻曰洟	source
子瑕	音遐本又作嘏古雅反	commentary
也中	丁仲反注及下注禮中之中同	commentary
冠字	古亂字	commentary
掘	求月反又求勿反	commentary
中霤	力救反	_
綴足	丁劣反又丁衞反	commentary
躐行	良輒反	commentary
不復	扶又反	commentary
子碩	音石	commentary
請鬻	本又作粥音育賣也注同	_
惡因	烏路反	commentary
蘧伯	本又作璩其魚反	commentary
玉從	才用反又如字	commentary
名拔	皮八反徐蒲末反	_
樂哉	音洛下同一讀下音五敎反	commentary
則瑗	于卷反又於願反	source
刺其	七賜反	commentary
弁人	皮彦反	commentary
孺子	而注反	commentary
可傳	直專反	commentary
括	古活反	source
嗤	昌之反	commentary
卜人師	依注音僕師長也謂大僕也本或無師字者非也前儒如字卜人及醫師也	commentary
從母	才用反	commentary
二夫人	音扶注同	commentary
相爲	于僞反注及下注夫爲妻同	commentary
爨緦	上七亂反下音絲	commentary
縱縱	依注音揔急遽貌	source
折折	大兮反安舒貌注同	source
陵躐	力輒反	commentary
怠惰	徒臥反	source
騷騷	素刀反急疾貌	commentary
謂大	音泰一音他佐反下注同	commentary
謂絞	户交反後同	source
紟	其䕃反	_
衾冒	莫報反	_
逺之	于万反	commentary
逺別	彼列反	_
妻期	音基	commentary
不知	音智	commentary
成味	依注音沫亡曷反	commentary
成斲	陟角反	_
縢	本又作滕徒登反	source
靧也	音悔洗面	commentary
竽笙	音于下音生	source
不和	胡臥反	commentary
之調	直弔反	commentary
簨	息允反橫曰簨	commentary
虡	音巨植曰虡	commentary
植曰	時力反又音值	commentary
問喪	問或作聞喪息浪反注及下皆同	_
孫于	音遜	_
朽	許久反	commentary
有爲	于僞反下爲桓司馬爲敬叔則爲之注爲民作爲嫁母皆同	commentary
宋向	式上反	source
戌	音恤	commentary
名魋	大回反	commentary
侈也	昌氏反又申氏反	_
而朝	直遥反注同	source
孟僖	許冝反	commentary
閱	音恱	commentary
將應	應對之應	commentary
汲汲	音急	source
繆公	音木	commentary
出竟	音境	_
焉得	於䖍反	commentary
公叔木	音式樹反又音朱徐之樹反	source
贈襚	音遂	_
子璅	息果反依字作瑣	_
滕伯	徒登反	source
爲孟	于僞反下及下注爲人同	source
伯鞏	恭勇反	commentary
外内易	以豉反	source
帷堂	意悲反	source
綌衰	去逆反麤葛也下七雷反	source
繐裳	音歳布細而踈曰繐	source
輕涼	音良	_
子皐	音髙	commentary
無相	息亮反	source
沽也	音古畧也	source
易之	音亦徐以豉反	source
稱家	尺證反	source
有亡	皇如字無也一音無下同	commentary
惡乎	音烏注同	source
齊	才細反又如字注同	commentary
豐省	所領反	source
之比	必利反	commentary
毋過	音無	commentary
還葬	音旋便也	commentary
縣棺	音玄	commentary
巳斂	力驗反	commentary
而封	依注作窆彼驗反下棺也徐又甫鄧反	commentary
設碑	彼皮反	commentary
繂	音律	commentary
作塴	北鄧反	commentary
士賁	音奔人名	commentary
汏哉	本又作大音泰自矜大	_
醯	呼兮反	commentary
醢	音海	source
甕	烏弄反	commentary
慶遺	于季反又如字	commentary
革矣	紀力反	commentary
不墾	苦很反	commentary
衎爾	苦旦反注同自得之貌	commentary
爲小君	于僞反下爲之殷爲其久爲君服同	commentary
深邃	先遂反	commentary
難人	乃旦反	commentary
見之	如字又賢遍反	commentary
反壤	而丈反	commentary
反復	扶又反舊音服非	_
大古	音泰	commentary
自燕	烏田反	source
爲壟	力勇反	commentary
坊者	音防	commentary
旁殺	色戒反下同	commentary
茨瓦	徐在私反茅覆屋	commentary
門廡	音武	source
卑	如字又音婢	commentary
狹	戸甲反	commentary
又易	以豉反	commentary
馬鬣	力輒反	_
斷其	音短下同	_
上之	時掌反下以上同	_
廣袤	古曠反下音茂徐又亡侯反	source
重􁆤	直容反	source
衣以	于旣反	commentary
椑	蒲歷反徐房益反櫬尸棺	source
杝	音移	commentary
堅著	直畧反	commentary
水兕	徐里反	commentary
漆之	音七	_
不令	力政反本又作合	_
楔齒	悉節反	commentary
綴	丁劣反又丁衞反	source
飯	煩晩反唅也	commentary
不剥	邦角反	commentary
也與	音餘下同	commentary
倮	力果反謂不巾覆也	source
埃加	音哀	commentary
乾腊	音昔	commentary
逮日	音代或大計反	source
縓	七絹反淺赤色今之紅也	source
縁	恱絹反下注同	source
於薫	本又作纁許云反	_
要絰	一遥反下注小要同下大結反	commentary
無絇	其俱反履頭飾	commentary
角瑱	吐練反充耳	commentary
衡	依字作横華彭反下衡三同	commentary
長袪	起魚反一音丘據反	_
謂褎	本又作袖音徐秀反	_
袂口	面世反	commentary
袪裼	音昔	_
麛裘	音迷本又作麑同鹿子也	source
靑豻	音岸胡地野犬	_
褎絞	戸交反	_
四重	直龍反注皆同	source
深邃	雖遂反	source
被之	皮寄反注同	_
其厚	胡豆反度厚薄曰厚皆同此音	commentary
杝棺	羊支反木名	source
椵杝	徒亂反	_
梓	音子	commentary
謂屬	音燭	_
周帀	本又作迊同子合反	commentary
能濕	乃代反	commentary
衽	而審反又而鴆反小要	commentary
髹	又作髤許求反	commentary
題	徒低反頭也	source
湊	七豆反聚也	commentary
䊷衣	本又作緇又作純同側其反	source
明爲	于僞反下文及注爲其變皆同	source
衍	以善反	commentary
菆塗	才官反	commentary
龍輴	勑倫反	source
畫轅	音袁	commentary
謂黼	音甫	_
以刺	七亦反	commentary
於縿	音消	commentary
幕	音莫	commentary
別姓	彼列反注同	commentary
於朝	直遥反下同	commentary
誄	力軌反	source
耆老	巨支反	source
莫相	息亮反佐也注同	source
尼父	音甫	commentary
其行	下孟反	source
大縣	郡縣之縣	commentary
皆厭	于葉反注同	source
大廟	音泰	source
惡野	烏路反	commentary
銜枚	上音咸下木坏反	_
叫呼	火故火胡二反	_
稅人	始銳反謂以物遺人也	commentary
謂遺	維季反	commentary
縞	古老反注同	commentary
紕	避支反	commentary
月禫	大感反	commentary
月樂	音岳	commentary
賜帟	音亦幕之小者	source
共焉	音恭本亦作供	_