月令第六	此是吕氏春秋十二紀之首後人刪合爲此記蔡伯喈王肅云周公所作
卷之五孟春昬參	所林反
中	如字徐丁仲反後放此
長也	丁丈反
於陬	足俱反又足侯反本又作娵同
訾	子斯反
爲人	于僞反
軋也	乙八反
解孚	音敷
大暭	上音泰後文及注大蔟大史大寢大室大微大廟大祝大尉大宰皆同噑亦作昊胡老反大暭宓戲也
句芒	古侯反下音亡句芒木正也少昊之子曰重爲之後句芒皆放此
宓戲	音密又音服戲又作亦作犧又作羲同許冝反
曰重	直龍反
律中	丁仲反猶應也後放此凡如此之例十二月文注皆可以類求之
大蔟	七豆反奏也
猶應	應對之應下皆放此
律長	直亮反又如字後皆放此
律空	徐音孔
臭羶	失然反
先脾	婢支反
於藏	才浪反後放此
直脾	丈吏反又如字下宿直同後放此
于奥	烏報反
及腎	時忍反
解凍	東送反
蟄蟲	直立反
上冰	時掌反下注以上同
獺祭	他達反又他瞎反
左个	古賀反偏也後放此
乗鸞	力官反
路	本又作輅
載靑	音戴後放此
旂	巨機反後放此
衣靑	於旣反後放此下注依甲保猶衣同
其􁏬	本又作器同
冬夏	此卷内可以意求之
衡璜	音黃
火畜	許又反
貫土	古亂反
朝祀	直遥反下文注同
龍卷	本又作衮古本反
玄端	音冕
先立春	悉薦反
乃齊	側皆反本亦作齋卷内放此
還乃	音旋後放此
命相	息亮反注同下善相幷注放此
施惠	如字又始豉反
休其	許收許虯二反美也
毋有	音無本亦作無下同
不當	丁浪反
宿	息六反徐音秀
離	依注音儷吕計反偶也
不貸	吐得反徐音二
馮	音憑
相	息亮反又如字
候伺	音司又息嗣反
載耒	力對反字林云耕曲水垂所作力佳反又力水反
耜	音似
措	七故反置也
保介	音界注同
帝藉	在亦反說文作耤云帝耤千畝
三推	出佳反又吐回反下同推謂伐也
參乗	繩證反
爲天	于僞反下爲仲春爲傷爲死氣皆同
勞酒	力報反注同
氣上	時掌反注土上同
萌動	莫耕反
蒸達	音證又之丞反
冒	莫報反覆也
橛	求月反
封疆	居良反注皆同
經術	古定反注同術依注音遂
田畯	音俊
之分	扶問反
嵎夷	音愚
阪險	上音反又蒲版反下許檢反
道民	音導
旣飭	音勑
農率	所類反謂田正
用牝	頻忍反
妊	而林而鴆二反
毋覆	芳服反
孩蟲	戸哀反
胎	吐來反
夭	烏老反
麛	音迷
卵	力管反
掩骼	江百反
埋胔	才賜反蔡云露骨曰骼有肉曰胔胔亦作骴
肉腐	扶矩反
蚤落	音早
有恐	丘勇反
大疫	音役
焱風	必遥反徐芳遥反本又作飄
宿直	音秀
好風	呼報反
藜	力兮反
莠	音酉
水潦	音老
大摯	音至蔡云傷折
首種	章勇反鄭云首種謂稷蔡云宿麥
仲春日在奎	苦圭反
昬弧	音胡
降婁	戸江反
夾鍾	古洽反一音頰
四隙	去逆反
倉庚	並如字本或加鳥非
驪黃	力知反
搏榖	音博
幼少	詩召反
省	所景反注同減也徐所幸反
囹	音零
圄	魚吕反囹圄今之獄
去	羌吕反
桎	音質今之械也
梏	古毒反今之杻也木在足曰桎在手曰梏
掠	音亮考捶
械	戸戒反
暴尸	歩卜反
捶治	之橤反
髙禖	音梅
施生	始豉反
孚乳	上如字一音芳付反下而樹反季春同
娀簡	夙中反簡狄有娀氏女
生契	息列反
九嬪	毗人反
謂從	才用反
弓韣	大木反弓衣
有娠	音身一音震謂懷妊
始電	大練反
先雷	悉薦反
奮鐸	方問反下大各反
度重	上音杜下音亮注同
斗甬	音勇斛也
權槩	古代反
稱上	尺證反下同
稱錘	丈僞反又丈爲反
闔扇	戸臘反
小閒	音閑
毋漉	音鹿竭也
陂池	彼冝反畜水曰陂穿地通水曰池尚書傳云澤障曰陂停水曰池
畜水	勑六反
乃鮮	依注音獻
朝覿	大歷反
冱寒	戸故反
朝之	直遥反
秬黍	音巨
皆與	音預
祭寒而藏之	本或作祭司寒案左氏傳無司字
之長	丁丈反
中丁	音仲本亦作仲
爲季	于僞反下注同
好雨	呼報反
大隂	音泰
煖氣	乃緩反又音暄
蟲螟	亡丁反爾雅云食苗心螟
季春在胃	音謂
季少	詩召反
姑洗	素典反
爲鴽	音如母無也蔡云鶉䳺之屬
虹	音紅又音絳蝶蝀也
始見	賢遍反
蓱始	歩丁反水上浮萍也
毋無	上音牟反如字
蝃	本又作螮丁計反亦作􁇧同
蝀	本亦作東同丁孔反
蓱萍	音平
曰蘋	毗人反
鞠衣	居六反如菊華也又去六反如麴塵
爲將	于僞反下文乃爲注爲鳥同
覆舟	芳服反下及注同
薦鮪	于軌反
發泄	息列反
句者	古侯反屈生也
倉廩	力甚反
上騰	時掌反下注以上同
循行	下孟反
隄防	丁兮反下音房
道達	音導
有障	之亮反又音章
便民	婢面反
罝	子斜反
罘	音浮
畢翳	於計反
餧	於僞反
獸罟	音古
爲弋	羊職反
桑柘	之夜反
戴勝	音帶注同本亦作載戴勝鳥名
織紝	女今反
曲植	直吏反曲薄也植蠶槌也
籧筐	居吕反亦作筥下丘狂反方曰筐圎曰筥
槌也	直追反又直類反又丈僞反
東郷	許亮反注同
毋觀	古喚反注同
省婦	所景反
去容	起吕反
線	息賤反
組	音祖
紃	音旬
分繭	古典反
效功	戸敎反
以共	音恭
敢惰	徒臥反
之量	音亮注同
筋角	音斤
箭幹	古旦反
凡輮	如九反
監工	古銜反注同
悖	必内反
淫巧	如字又苦孝反注同
春液	音亦
累牛	力追反注同
騰	大登反
遊牝	毗忍反徐扶死反
皆乗	繩證反
在廏	居又反
挍數	所主反
國難	乃多反後及注同驅疫鬼
磔	竹栢反磔磔牲也
穰	本又作攘如羊反
氣佚	音逸後同
索宝	所白反
敺疫	丘于反
大恐	丘勇反
暵	呼旱反又呼旦反
蚤降	音早
孟夏婺女	音務
言炳	音丙
長育	丁丈反此月内除律長長大繼長皆同
著見	賢遍反
炎帝	于廉反炎帝神農也
顓頊	上音專下音朂
音徴	張里反後放此
去一	起吕反
中吕	音仲又如字
無射	音亦
臭焦	子遥反
先肺	芳廢反
竈陘	音刑
螻	音樓
蟈	古獲反螻蟈蛙也蔡云螻螻蛄蟈蛙也
蛙	烏蝸反即蝦蟇也
丘蚓	以忍反
萆挈	上皮八反下起八反
王萯	房九反
赤駵	音留本又作騮
菽	本又作叔音同
以粗	七奴反大也
木畜	許又反下水畜同
先立	悉薦反
欣說	上許斤反下音恱
熛怒	必遥反下奴故反
爲將	于僞反下爲逆爲妨爲傷下文爲天子皆同
飲酎	直又反重釀之酒
長大	如字下繼長同或丁丈反非也
必當	丁浪反
蕃廡	音煩下亡甫反下同
有壊	音怪注同
墮	許規反又作隳下注同
始絺	勑其反
出行	下孟反下同
勞農	力報反
聚畜	丑六反又許六反
斷薄	丁亂反注同
薺	才禮反
草艾	魚廢反後皆同
言醇	音純
謂重	直龍反或直用反
釀	女亮反
於朝	直遥反
飲蒸	之承反後皆同
數來	所角反
則蝗	徐華孟反范音横字林音黄
仲夏昏亢	音剛又苦浪反
蕤賔	人誰反
應鍾	應對之應
交酢	才各反
螳	音堂
蜋	音郎螳蜋螵蛸母也
鶪	古闃反搏勞鳥字林工役反
反舌	鄭云百舌鳥蔡伯喈云蝦蟇
螵	匹遥反
蛸	音消
搏勞	音博又作伯
壯佼	古卯反
助長	丁丈反下長氣同
鞀	大刀反本亦作鞉同
鞞	步西反
竽	音于
竾	音池本又作篪同
簧	音黄
飭鐘	音勑
柷	昌六反
敔	魚吕反本又作圉
為將	于偽反下文為民注為傷為其皆同
大雩	音于
百辟	必亦反注同
句龍	古侯反
龍見	賢遍反下御見同
以雛	仕于反又仕俱反雞也爾雅云生啄雛
含桃	本又作函湖南反含桃櫻桃也
櫻	於耕反
艾藍	力甘反
可別	彼列反下文別羣同
暴布	歩卜反
大陽	音泰
無索	所白反
不難	乃旦反又如字
挺重	大頂反寛也
則執	如字蔡本作縶
相蹄	大計反蹋也本或作踶音同
廋人	所留反
敎駣	音兆又音道字林音桃
陽爭	爭鬪之爭注同
從八能	子用反
致和	戸臥反
嗜欲	市志反
晏隂	伊見反
角解	戸買反
蟬始	市志反
半夏	戸嫁反半夏藥草
木堇	音謹木堇王蒸也一名舜華
王蒸	之承反
臺榭	音謝
樓觀	古喚反
闍者	音都
雹	歩角反
凍	丁貢反
百螣	音特食苗葉蟲
乃饑	居疑反又音機
零落	本又作苓音同
民殃	於良反
疫	音役
季夏去一	起吕反後放此
不任	音壬又如字
純恪	苦各反
蟋蟀	上音悉下音率
腐草	扶矩反
爲熒	本又作螢戸扃反螢火蟲也或作腐草化爲螢者非也
攫	俱縛反一音九碧反
搏	音博
始鷙	音至本亦作摯同
蛟	音交
鼉	大多反又徒丹反
黿	音元
冒	亡報反
榜人	必孟反
材葦	于鬼反
柔刄	而愼反
爲艾	于僞反下文爲民注爲求福爲其同
以共	音恭
黼	音甫
黻	音弗
差貸	音二又他得反
以別	彼列反
旗	音其
章識	申志反又如字
行木	下孟反
傜役	音遥
徑	音逕
辱暑	如字本或作溽音同濕也
燒薙	他計反芟草又直履反
芟草	所銜反
萊地	音來
夏日	人一反
畜於	勑六反
不復	扶又反
以糞	方問反
土疆	其丈反注同
易行	以豉反
強	其兩反
㯺	好覽反
鮮落	音仙又仙典反
風欬	苦代反
鷹隼	息允反
蚤鷙	上音早下音至亦作鷙擊也
走竄	七亂反
中央	於相反
蟲倮	力果反虎豹之屬淺毛者又乎瓦反
露見	賢遍反
中􁆤	力又反
複穴	方服反
五藏	才浪反
圜	于權反
以閎	音宏
之長	丁丈反
土畜	呼又反一金畜同
孟秋少暭	詩召反注下放此少暭金天氏黃帝之子
蓐收	音辱蓐收少暭之子曰該爲之
應涼	應對之應
狐貉	户各反依字作貈
生􁇁	之然反
則陂	彼義反
左樞	昌朱反
行戮	音六
寒蜩	大彫反
蜺也	五兮反寒螿
緫章	子孔反
白駱	音洛
黒鬣	音獵本亦作髦音毛又一本作旄尾也
先立秋	悉薦反
軍帥	所類反下同本或作師注放此
於朝	直遥反
招拒	音矩
諸將	子匠反下同
詰誅	去吉反
好惡	並如字又上呼報反下烏路反
繕囹	市戰反
罪邪	似嗟反
搏執	音博
察創	初良反注同
審斷決	丁亂反下同蔡徒管反一讀絶句決字下屬
贏	音盈注同
猶解	古賣反
完	胡官反
隄	本又作提丁兮反
防	本又作坊音房
謹壅	於勇反
畢好	呼報反
坏	歩回反
牆垣	音袁
大使	色吏反
介蟲	音界注同
稻蟹	胡買反
復還	扶又反下音環又音旋
多瘧	魚畧反
仲秋觜	子斯反又子髓反
觿	戸圭反又戸規反
盲風	亡庚反疾風
謂閩	音文依字作蟁又作蚊
蚋	人銳反又如恱反
其養	餘亮反下同
糜	亡皮反
粥	之六反字林羊六反
具飭	丑力反後放此
有量	音亮下度量同
朝宴	直遥反
此爲	于僞反下爲民同
必當	丁浪反下不當及注同
枉	紆往反
橈	女敎反又乃絞反字林作撓非
申重	直用反
循行	下孟反
芻	初俱反草也
豢	音患養也養牛羊曰芻犬豕曰豢以所食得名
瞻	音占
肥瘠	在亦反
皆中	丁仲反
乃難	力多反注同
竇	音豆
窖	古孝反
脩囷	丘倫反
隋曰	他果反謂狹而長
趣民	七住反本又作趨又七緑反
坏戸	音陪
務畜	丑六反
浸盛	子鴆反
始涸	戸名反竭也
角見	賢遍反下同
易關	以豉反注同
便	婢面反
匱	其位反注同
賈客	音古又古雅反
應陽	應對之應
有恐	丘勇反
復生	扶又反
數	所角反
季秋無射	音亦
喆	貞列反
來賔	髙誘注吕氏春秋則云賔雀與鄭異
爲蛤	古荅反
鞠	本又作菊九六反
豺	音柴
僇禽	音六本或作戮
申重	直用反
之簿	歩古反徐歩角反
之收	如字又守又反
之委	紆僞反
猥卒	温罪反下七忽反
習吹	昌睡反注同
爲將	于僞反下文縣爲注主爲又爲同
徧祭	音遍
合諸侯制	絶句
而縣	音玄
殳	音殊
矛	亡侯反
度	大各反
同乗	繩證反
校人	戸敎反
而頒	音班
騶	側求反
載	丁代反又如字注同
旐	音兆
以級	九立反
趣馬	七注反又七走反
駕說	始銳反
之陳	直覲反
大常	音泰
載旟	音餘
搢	如字又音箭
扑	普卜反
挾矢	子協反又音協
祀祊	鄭注周禮音方
爲炭	吐旦反
皆墐	其靳反
辟殺	音避
乃趣	音促又七住反
不當	丁浪反注同
供養	九用反下餘亮反注同
以去	起吕反
貪耆	市志反
熊	乎弓反
蹯	音煩
鼽	音求說文云病寒鼻窒
嚔	丁計反
邊竟	音境注及後同
隆	六中反
坼	丑白反
煖風	乃管反又許元反
氣解	古買反
惰	徒臥反
孟冬析木	思歷反
顓	音專
頊	許玉反顓頊髙陽氏
玄冥	亡丁反少昊之二子脩及熙爲玄冥玄冥水官
龜鼈	必滅反
財匱	其位反
應	應對之應注同
臭朽	許九反本亦作㱙字林云㱙腐也說文云㱙或爲朽字
辟除	必亦反又婢亦反
爲軷	歩曷反
壤	如丈反
厚二	戶豆反
廣五	古曠反
爲蜃	常忍反大蛤
不見	賢遍反下注録見同
鐵驪	力知反
與彘	直吏反
爲袗	之忍反又之刄反
先立冬	悉薦反
叶光	本又作汁音協
禺人	音遇
椓聚	丁角反又作涿同
釁龜	許靳反
筴	初格反
蓍	音尸
繇文	直又反
相爲	于僞反下爲仲冬爲天子皆同
上騰	時掌反又如字下上泄同
蓋藏	才浪反又如字
循行	下孟反
積聚	子賜反下才柱反又並如字仲冬同
鍵閉	其輦反又其偃反
管籥	羊灼反
封疆	居良反注及下注同
要塞	先代反注同
塞徯	上先則反下音奚
徑	古定反
鍵牡	亡古反又茂后反
搏鍵	音博一本作傳直專反
害處	尺慮反
爲璽	音徙
塋	音營
丘壟	力勇反
襲	音習
斂	力驗反又力檢反
效功	戸敎反
淫巧	如字又苦孝反注同
功致	直吏反下注同
之長	丁丈反
不當	丁浪反注同
別之	彼列反
國索	所百反
屬民	之玉反下同
滌	大歷反
場	直良反
躋彼	子兮反
兕	徐履反
觵	古宏反
臘先祖	力合反
謂蜡	仕迓反字林作䄍
勞農	力報反
將帥	上子匠反下色類反
大閱	音悅
唯狩	手又反
上泄	息列反下同
復出	扶又反
參伐	所林反下同
仲冬東辟	必亦反又必狄反
益壯	莊亮反
曷旦	本亦作鶡同苦割反曷旦鳥名
暢月	勑亮反充也
猶女	音汝
大隂	音泰
必重	直龍反注同
省婦	所景反注同
大酋	子由反又在由反大酋酒官之長
秫稻	音述
麴	丘六反
糵	魚列反
湛	子廉反漬也
熾	尺志反炊也
火齊	才計反注火齊同
監	古銜反
差貸	音二又他得反注同
之長	丁丈反
穫稻	戸郭反
畜獸	許六反
不詰	起吉反
藪澤	素口反
敎道	音導
陽爭	爭鬪之爭注同
去聲	起吕反注及下同
禁耆	市志反
從八	子用反
芸	音云香草
茘	力計反馬䪥
挺出	大頂反
馬䪥	戸介反
麋	亡悲反
角解	音蟹
上行	時丈反
氛霧	芳云反
雨汁	于付反下音執注同謂雨雪雜下也
瓜瓠	戸故反
好雨	呼報反
多疥	音介
季冬婺女	無付反
昬婁	力侯反
旦氏	丁兮反一音丁計反
玄枵	許驕反
北郷	音向
雉雊	古豆反雉鳴
雞始乳	如住反
大難	乃多反下注同
磔出	竹百反
爲厲	于僞反
題肩	大兮反
神祇	音祁
腹堅	本又作複又方服反厚也
五種	章勇反注同
鎡	音兹
錤	音其
合	古荅反
吹	昌睡反
而罷	如字又音皮
乃復	扶又反
君子說	音恱
小人樂	音洛
以共	音恭下文以共皆同
薪燎	力召反
可析	思歷反下同
炊爨	七亂反
幾終	音祈又音機
故處	昌慮反
猶女	音汝
令之	力呈反
而縣	音玄
辟寒	毗異反
胎	吐來反
夭	烏老反注同
少長	上詩召反下丁丈反
乃句	古侯反
消釋	如字一本作液音亦
