禮運第九	鄭云禮運者以其記五帝三王相變易及隂陽轉旋之道
卷之七與於	音預
蜡	仕嫁反索也祭名夏曰淸祀殷曰嘉平周曰蜡秦曰臘字林作䄍
索	所百反
於觀	古亂反注同闕也
喟然	去媿反又苦怪反說文云大息
之處	昌慮反下同處同
逮	音代及也一音代計反
俊選	宣面反下文皆同
爲其	于僞反下文爲己皆同
禪位	善面反
所長	丁丈反
矜寡	古頑反
無匱	其媿反
有分	扶問反注同
良奥	烏報反
惡其弃	上烏故反下同
不憚	大旦反
施無	始豉反
吝心	力刄反又力覲反
禦風	魚吕反
傳位	丈專反
俗狹	音洽
嗇	音色
勇知	音智
敦朴	普角反
之稠	直由反
成治	直吏反
在埶	音世本亦作勢
者去	羌吕反注同
爲殃	於良反
復問	扶又反下復問同
相鼠	息亮反注同
遄死	市專反疾貌
殽於	戸敎反法也徐戸交反
冠昬	古亂反
朝聘	直遥反
則易	以豉反
之極言	如字徐紀力反
聞與	音餘
有小正	音征本或作有夏小正
坤	苦門反
乾	其連反
其燔	音煩
捭豚	卜麥反注作擗又作擘皆同
汚尊	烏華反注同一音作烏
抔	歩侯反手掬
蕢	依注音􁏷苦對反又苦怪反土塊也
桴	音浮鼓槌
齊敬	側皆反
釜	本又作鬴音父
甑	即孕反
燒石	如字又舒照反
鑿地	在洛反
掬	九六反本亦作臼音蒲侯反
堛	普逼反
摶土	徒端反
築	徐音竹
屋而號	戸毛反
皐某	音羔
飯	扶晚反注同
腥	音星
而苴	子餘反苞也徐爭初反
遣奠	弃戰反
知氣	音智
北首	手又反注同
南郷	許亮反注同
營窟	苦忽反
居橧	本又作増又作曽同則登反
樔	本又作巢助交反
茹其	音汝
衣其	於旣反
鑄作	之樹反
合土	如字徐音閤
令	音零
甓	歩歷反
及甒	音武
大也	音泰甒大皆樽名
臺榭	音謝本亦作謝
牖戸	音酉
以炮	薄交反徐扶交反
裹燒	音果
以燔	音煩加於火上
亨	普伻反煑也下合亨同
鑊	户郭反
以炙	之石反
貫之	古亂反
醴	音禮
酪	音洛
烝	之承反
釀	女亮反
酢	七故反
酨	才再反徐祖兾反
醴醆	側眼反
粢	依注爲齊才細反注五齊皆同
醍	音體
祝嘏	本或作假古雅反
之祜	音戸福也
粢讀	音咨
泛齊	芳劒反徐音汎
盎齊	烏浪反
爲主人	于僞反下同
其祝	之六反徐之又反注同
其殽	本或作肴戸交反
越席	音活注同字書作趏越席翦蒲席也杜元凱云結草
以幂	本又作鼏同莫歷反
衣其	於旣反
澣帛	戸管反
示號	音祇本又作祇
齍號	音咨皇云黍稷
大古	音泰下大史同
爓	似廉反
染	如豔反又如琰反
樂也	音洛
鈃	本又作鉶音刑盛和羹器形如小鼎
羮	音庚舊音衡
分別	彼列反下文同
於	音烏
乎	好奴反
吾舎	音捨下舎禮皆同
郊禘	大計反
鼷鼠	音兮
契	息列反
醆斝	古雅反又音嫁爵名也夏曰醆殷曰斝周曰爵
僭君	子念反注同
脅君	許劫反
儗於	音擬
焉	於䖍反
期不	居其反
入朝	直遥反注同
或與僕相	息亮反一讀如字則連下爲句
等輩	卜内反
弟鍼	其廉反又祇廉反
千乗	時證反
壞法	音怪
諱惡	烏路反
自拱	徐居勇反後拱持同
爲謔	許約反
孔甯	本又作寧案左傳作寧公羊作甯各依字讀
行父	音甫
數如	色角反
取殺	申志反或如字
大柄	兵命反
儐鬼	必刄反
以治政	皇如字徐直吏反下文注以治政同
爲言	于僞反下又爲遂爲皆同
所操	七刀反
臣倍	歩内反
俗敝	音弊本亦作弊
疵國	才斯反病也
肅峻	恤俊反
煇光	音暉
不見	賢遍反
殽以	戸教反注及下同
土㑹	古外反
而上	時掌反下上配上生皆同
共國	音恭
所樂	音岳又音洛又五孝反好也注同
治也	直吏反注同下以自治注身治成治皆放此
並倂	歩頂反
過差	初佳反一音初買反
何以守位曰仁	本亦作人
所養	羊尚反又如字下同
百姓則君	則音明岀注
分定	扶問反後文注除三分去一三分益一皆同
舎義	音捨
之知	音智注同
去其	羌吕反後皆同
之斷	丁亂反
之施	始豉反下施生同
謂之變	音辯岀注
耐以	音能
辟於	婢亦反開也徐芳益反
傳書	丈專反
愛惡	烏路反下皆同
弟弟	上如字下音悌
長惠	丁丈反
爭奪	爭鬪之爭
測度	大洛反
不見	賢遍反
竅於	徐苦弔反孔也
播於	彼左反舒也
五行四時	絶句本亦作播五行於四時
屈伸	音申
迭相	大計反又田結反
竭也	義作揭其列反負擔也
還相	音旋下同
六和	戸臥反注同
更相	古衡反下同
角徴	張里反
南事	律名京房律始於執始終於南事凡六十
畫繢	戸對反
以圜	音環又音圎
別聲	彼列反
被色	皮義反徐扶義反
爲柄	本又作枋兵命反
爲量	音亮下同
爲畜	許又反下同
政治	直吏反
於麟	良人反
相近	附近之近
操	七刀反
所捊	蒲侯反徐音普溝反
介僎	上音界下音遵
可睹	丁古反
爲倪	五計反視也
魚鮪	于軌反魚名
淰	音審徐舒冉反
矞	字又作獝況必反
狘	況越反
閃	失冉反
秉蓍	音尸
瘞	於例反一音於器反
繒	本又作増同似仍反又則登反又似登反
儐鬼	皇音賔敬也舊必信反
在朝	直遥反下同
卜筮	市制反
瞽	音古
侑	音又
皆應	應對之應
列宿	音秀
之藏	如字徐才浪反
大一	音泰下注同
合於月之分	本或作日月之分日衍字
曰養	音義出注
冠昬	古亂反
摯幣	本又作贄音至
罷也	音皮
大竇	音豆孔穴也
壞國	音怪又乎怪反
喪家	息浪反
有糵	魚列反
醇耳	市春反
養菁	子丁反
耨之	奴豆反鉏也
所盛	市正反又音成
乖刺	力達反本或作制
無耜	音似
不種	之用反不亦作弗何休注公羊云弗者不之深也下皆放此
不穫	戸郭反
知收	如字又手又反
不見	賢遍反
不苑	于粉反積也
不繆	音謬
有畜	丑六反
不殺	所戒反徐所例反注同
渚者	之汝反
漁人	音魚
獻鼈	必列反
蜃	石忍反
司爟	古亂反
卝人	華猛反又瓜猛反徐古猛反
仲夏	戸嫁反下同
謂食	音嗣
齊	才細反下皆同
頒爵	音班
必當	丁浪反
媒氏	音梅
而取	音娶本又作娶
稽士	古兮反
之烖	音災
妖孽	又作蠥魚列反妖又作祅說文云衣服歌謡草木之怪謂之祅禽獸蟲蝗之怪謂之蠥
螟	亡丁反
螽	徐音終
澧	本又作醴音禮
麒麟	音其下音票人反
郊棷	素口反徐揔㑹反澤也本或作藪
宫沼	之紹反池名
卵	力管反
胎	土才反
可俯	音府
而窺	本又作闚去規反
銀甕	本亦作罋烏弄反徐於弄反
