内則第十二	鄭云以其記男女居室事父母舅姑之法	source
后王	鄭云后君也謂諸侯也王天子也盧云后王后也王天子也孫炎王肅云后王君王也	source
幷六卿	必政反	_
或兼	如字一音古念反	commentary
咸盥	音管洗手	commentary
漱	所救反徐素遘反漱漱口也下同	commentary
櫛	側乙反梳也	commentary
縰	所買反徐所綺反黒繒韜髮	commentary
笄	古兮反	commentary
緫	子孔反束髮也	commentary
拂髦	音毛	commentary
冠緌	耳佳反緌纓飾也	commentary
韠	音必	commentary
紳	音申大帶	commentary
搢	徐音箭又如字音晉插也	commentary
笏	音忽	commentary
韜髮	吐刀反	commentary
振去	起吕反	commentary
著之	丁畧反下文及注同	commentary
鬌	多果反	commentary
扱	本又作捷又作插初洽反徐采協反	commentary
使令	力呈反	commentary
紛	芳云反拭物巾或作帉同	source
帨	始銳反佩巾也	commentary
小觿	許規反本或作鑴音同解結錐	commentary
金燧	音遂火鏡	commentary
拭物	音式	commentary
礲	力工反	_
捍	戶旦反拾也謂射捍	source
管遰	時世反徐作滯刀鞞也	commentary
筆彄	苦侯反	commentary
刀鞞	必頂反	commentary
鑚火	子官反	source
偪	本又作幅彼力反行縢也	source
行縢	徒登反	source
屨	九具反	commentary
著綦	其記反注及下同屨繫也	source
如父母	一本作如事父母	commentary
衣紳	如字又於旣反注同	commentary
今簪	徐側林反又作南反	_
箴	之林反	commentary
線	本又作綫息賤反	commentary
纊	音曠	commentary
縏	字又作槃同步干反	commentary
袠	陳乙反又作帙	commentary
小囊	奴郎反又作橐徐音託	commentary
明為	于偽反	_
衿嬰	本又作紟其鴆反結也注同嬰又作纓	_
衣燠	本又作奥同於六反暖也	_
苛	音何疥也	_
養	本又作癢以想反	commentary
搔之	素刀反摩也	source
怡說	音悦	commentary
苛疥	音界說文云瘙瘍也	source
時便	婢面反	commentary
少者	詩召反後皆同	commentary
奉槃	芳勇反本或作捧下同	commentary
長者	丁丈反後皆同	commentary
以帨	始銳反拭手也本又作挩同	_
以溫	本又作蕰又作慍同於運反注同	_
藉也	字夜反	commentary
饘	之然反厚粥也	commentary
酏	羊支反薄粥也	commentary
芼	毛報反	commentary
蕡	字又作黂扶云反徐扶畏反大麻子注同	commentary
粱	音良	commentary
秫	音述	commentary
粥	之六反又羊六反	commentary
熬	五羔反	commentary
枲實	思里反	commentary
飴	羊之反餳也	commentary
堇	音謹菜也	commentary
荁	音丸似堇而葉大也	commentary
枌	扶云反白榆也	commentary
免	音問注同新生曰免	commentary
薧	字又作槀苦老反乾也	commentary
滫	思酒反溲也	commentary
瀡	音髓滑也	commentary
以滑	胡八反又于八反諸卷皆同	commentary
以膏之	古報反	commentary
調	如字又徒弔反	commentary
和	如字又胡臥反	commentary
夏用	戸嫁反	commentary
溲	所九反	commentary
未冠	古亂反	commentary
爲迫	于僞反	source
而朝	直遥反下而朝同	commentary
後成人	如字徐胡豆反下同	source
衣服	如字又於旣反	commentary
枕簟	徒點反	source
灑	本又作洒所買反又所賣反	commentary
埽	素報反	commentary
􁅈子	如樹反	_
蚤寢	音早	_
以上	以或作巳上時掌反後放此	source
奉席	芳勇反下同	commentary
何郷	許亮反	commentary
將衽	而鴆反又而甚反臥席也	_
何止	本又作趾足也	_
臥處	昌慮反	_
縣衾	音玄	commentary
篋枕	口協反	commentary
而襡	音獨韜也	commentary
不傳	丈專反注同移也	_
敢近	附近之近	_
敦	音對又丁雷反	source
牟	木侯反齊人呼土釡爲牟	source
巵	音支酒器也	_
匜	羊支反一音以氏反杜預注左傳云沃盥器也	_
非餕	音俊	_
如堥	字又作蝥木矦反	_
應唯	于癸反徐伊水反	_
愼齊	側皆反	_
噦	於月反	_
噫	於界反	_
嚏	音帝	_
咳	苦愛反	source
欠	丘劒反	_
伸	音申	_
跛	彼義反	_
倚	於義反又其寄反	_
睇	大計反傾視也	_
視	如字徐市志反	source
唾	吐臥反	commentary
涕	本又作洟同吐細反	_
重衣	直龍反	_
袒	音但	_
裼	思歷反	_
撅	居衞反揭衣也	_
揭衣	起例反又起列反一音起言反	_
不見	賢遍反下同	source
爲其	于僞反	commentary
可穢	紆廢反又烏㑹反	source
刷	色劣反	commentary
去	丘吕反	source
帶垢	古口反	commentary
請漱	素侯反後皆同	source
請澣	本又作浣户管反	commentary
和漬	似賜反	commentary
綻	字或作䘺直莧反徐治見反	commentary
裂	本又作列	commentary
紉箴	女陳反徐而陳反下之林反	commentary
補綴	丁劣反又丁衞反	_
猶解	胡賣反又佳買反	source
燂湯	詳廉反温也	commentary
潘	芳煩反淅米汁	source
靧	音悔洗面	commentary
瀾	力旦反	source
喪遽	其據反	_
以篚	非鬼反	commentary
共湢	彼力反本又作偪浴室也	commentary
不嘯	依注音叱尺失反	commentary
障也	音章	source
解也	佳賣反下解倦同	commentary
若飮	於鴆反	_
食	音嗣	source
不耆	市志反	source
而去	起吕反本又作而食之	source
謂難	乃旦反	commentary
姑予	以渚反下同	_
逺	于万反	commentary
懟	直類反本又作懃	commentary
姑縱	本又作從足用反	commentary
寧數	色角反	_
譴責	弃戰反	source
猶爲	于僞反	commentary
說則	音悅下同	commentary
而撻	吐達反擊也	commentary
思貽	以之反遺也	source
遺也	以季反	commentary
謂傳	丈專反	commentary
介婦	音界注及下同	commentary
解勌	本又作倦其卷反	_
掉磬	徒弔反隱義云齊人以相絞訐爲掉磬崔云北海人謂相激事爲掉磬也	commentary
下冡	戸嫁反	source
使令	力呈反	commentary
私畜	許六反又許又反又勑六反	commentary
茝蘭	本又作芷昌改反韋昭注漢書云香草也昌以反又說文云虈也虈火喬反齊人謂之茝昌在反	commentary
必復	扶又反	source
適子	丁曆反	commentary
皆齊	側皆反	commentary
稰	思吕反熟穫曰稰	commentary
穛	側角反生穫曰穛	commentary
膷	音香牛􁂄也	source
臐	許云反羊􁂄也	commentary
膮	許堯反豕􁂄也字林云豕羹也火攸反	source
牛炙	章夜反下同	commentary
胾	側吏反	commentary
牛膾	古外反	commentary
芥醬	徐姬邁反	source
鶉	順倫反	source
鷃	音晏	source
公食	音嗣酏食糝食並同	commentary
爲鴽	音如下文同	commentary
重醴	直龍反注同陪也	commentary
淸糟	子曹反徐徂到反	_
醇也	常倫反	source
淸泲	子禮反	_
酢	七故反	commentary
酨	才載反	_
醷	本又作臆於紀反徐於力反	source
濫	力暫反	commentary
以諸	乾桃乾梅皆曰諸	commentary
糗	起九反又昌紏反	commentary
餌	音二下同	commentary
酏	讀曰􁉸又作餰之然反又之善反	source
擣	本又作搗丁老反下同	commentary
與餈	本又作粢自私反下同	source
糝	西感反	source
狼臅	昌録反徐又音燭	commentary
食	音嗣飰也下苽食麥食食齊皆同徐如字	commentary
蝸	力戈反	commentary
醢而苽	音孤字又作菰同	commentary
雉羹	絶句麥食	commentary
脯羮雞羹	絶句	_
折	之列反	_
稌	音杜徐他古反稻也	commentary
和糝	上胡臥反下三敢反注同	commentary
不蓼	音了	commentary
羮齊	才細反下文同	_
析	星曆反下同	commentary
濡豚	音而下同	commentary
苞苦	伯交反	_
濡雞醢	音海一本作醯呼兮反次下句同	commentary
卵醬	依注音鯤古門反魚子也	source
亨	普彭反煑也	source
荼	音徒	source
作􁏦	音關本又作捫音門	source
腶脩	丁亂反	commentary
蚳	直其反蟻子也	source
捶脯	徐之橤反	commentary
蜱	本又作蚍音毗	commentary
蜉	本又作■音浮	commentary
卵鹽	力管反	commentary
爲胖	音判	source
視夏	戸嫁反下放此	commentary
膏薌	音香牛膏	commentary
腒	其居反乾雉也盧云雉腊也說文云北方謂鳥腊曰腒	commentary
鱐	本又作䐹所求反乾魚也	commentary
膏臊	素刀反犬膏也	commentary
麛	音迷鹿子也	commentary
膏腥	音星雞膏也說文作胜云犬膏臭也	source
膏羶	升然反羊膏也	commentary
爲其	于僞反	source
大盛	音泰	source
麏	九倫反本又作麇又作麕下田豕麏同	source
有軒	音憲出注後放此切肉如藿葉也	commentary
蜩范	上音條蜩蟬也下音犯范􁑌也	source
􁑌	本又作蜂芳凶反	_
芝	音之	commentary
栭	音而本又作檽	source
蔆	音陵芰也	_
椇	音矩枳椇	commentary
榛	側巾反	commentary
􁇖	音俟	_
柤	側加反	source
芰	其寄反	commentary
枳椇	上居氏反	source
用䪥	戸界反俗本多作薤非也	_
藙	魚氣反茱萸也	source
㑹	古外反	source
稽	古兮反	source
之榝	色八反似茱萸而實赤小	commentary
和	戸臥反注皆同又如字	commentary
用醯	呼兮反酢也	commentary
畜與	許又反又許六反	commentary
鶉雞羮	本又作鶉羹雞羹	_
魴鱮	上音房下音敘	source
烝	皇絶句之丞反	commentary
雛	字又作鶵仕俱反又匠俱反賀讀魴鱮烝雛爲句	commentary
燒	如字一音焦皇絶句	commentary
雉	皇此一句一讀雉薌爲句	source
蘇荏	而甚反	source
言調	徒弔反	commentary
狼去	起吕反下並同	commentary
尻	苦刀反	source
腦	奴老反	commentary
皆爲	于僞反下皆爲同	source
伏	扶又反	commentary
乳	而樹反	source
鰫魚	音容	source
如篆	直轉反	source
鯁人	本又作哽古猛反字林云鯁魚骨也又下孟反	source
竅也	苦叫反	commentary
膽	丁敢反	commentary
攅之	再官反本又作鑚	source
庮	音由惡臭也	source
泠	音零泠結毛如氈也	source
毳	昌銳反	source
而躁	早報反	source
麃	本又作皫劉昌宗音普保反徐芳表反又普表反	commentary
而沙	如字一音所嫁反注同	commentary
交睫	音接	source
腥	依注作星皇云肉中如米者說文云腥星見食豕令肉中生小息肉也字林音先定反	commentary
而般	音班	source
臂	本又作擘必避反徐方避反	commentary
漏	依注音螻力侯反	source
鵠	胡篤反	commentary
鴞	于驕反	source
胖	音判	commentary
鴇	音保	commentary
奥	於六反	commentary
鹿胃	音謂字又作􁉼同	commentary
一薫	許云反或作焄又作葷	commentary
不解	胡買反	commentary
嘶也	音西字又作斯音同	commentary
腐臭	扶甫反	commentary
前脛	胡定反	commentary
螻蛄	音姑	_
鵝	五何反	source
鶩	音木	commentary
脾	扶移反	source
肶	昌私反	commentary
肉腥	音星字林作胜云不熟也先丁反	source
聶而	本又作攝又作䐑皆之涉反下同	commentary
麏爲	九倫反	commentary
辟鷄	必益反徐芳益反注同	_
爲宛	于晚反	commentary
脾	婢支反	commentary
諸醯	徐呼兮反本或作䤈	commentary
鹿􁌐	於僞反益州人取鹿殺而埋之地中令臭乃出食之名鹿􁌐是也	commentary
近由	附近之近	commentary
羮食	音嗣注羹食并下文食禮同	source
庪食	字又作庋九委反或居彼反本亦作處	_
於坫	丁念反	commentary
夾室	古洽反又古協反	source
同處	昌慮反	commentary
異粻	知良反糧也字林云量也	commentary
絞	戸交反	source
紟	其鴆反本又作衿同	commentary
衾冒	亡報反	_
不煖	乃管反	source
於朝	直遥反下同	commentary
珍從	才用反又如字	commentary
不與	音預下同	commentary
齊喪	側皆反	_
衰麻	七回反	commentary
東膠	音交	commentary
冔而	況甫反	_
縞	古老反又古報反	source
樂其心	音洛下同	commentary
忠養	羊亮反	commentary
爲法	于僞反	commentary
德行	下孟反	commentary
三王有	音又出注	commentary
爲惇	音敦敦厚也	_
淳熬	之純反下五羔反下及注同	source
淳母	依注音模莫胡反下同	commentary
黍食	音嗣	commentary
炮	歩交反	commentary
若將	依注音牂子郎反牝羊也	commentary
刲	苦圭反	commentary
刳之	口孤反又口侯反	commentary
編	必緜反又歩典反	commentary
萑	音丸蘆也	commentary
以苴	子餘反苞裹也	commentary
以謹	依注作墐音斤徐如字	commentary
炮之	絶句	commentary
涂皆乾	絶句涂本亦作塗	source
擘之	必麥反絶句	commentary
濯手	直角反	source
去其	起吕反注同	commentary
皽	章善反魄莫也	commentary
糔	息酒反又相流反又息了反	commentary
溲	所九反	commentary
以付	徐音賦	commentary
鉅	音巨其據反	commentary
鑊	戸郭反	commentary
使湯	一本作使其湯	source
穰	羊如反草也	commentary
魄莫	上普伯反或普博反下亦作漠武博反	commentary
解析	星曆反	commentary
必脄	音每徐亡代反夾脊肉	commentary
其餌	音二筋腱也本或作皽下句作餌	commentary
筋	音斤	commentary
腱	徐其偃反皇紀偃反一音其言反隱義云筋之大者王逸注楚詞云筋頭也	commentary
醯與	音餘	_
湛諸	子濳反直䕃反又將鴆反一音陟鴆反注同漬也	commentary
期朝	音朞	commentary
以洒	所買反徐西見反	source
而鹽	音豔又如字	commentary
乾而食之	一本無而食之三字	source
濡肉	音儒下同	commentary
肝膋	音遼徐音勞	commentary
食	音嗣下酏食同	commentary
幪之	音蒙	commentary
舉焦	字又作燋子消反	_
爲酏	讀爲􁉸之然反又之善反注􁉸同	commentary
臆	音憶	commentary
􁊰矣	本又作􁉸又作䬤並同之然反又音賛	_
􁆻寺	音昬	_
同杝	本又作椸以支反	_
枷	音嫁	commentary
縣	音玄	source
之楎	音輝	_
篋笥	息吏反	commentary
竿謂	音干	commentary
楎杙	音弋	_
無閒	徐間厠之閒皇如字讀	_
年未五十	本又作年未滿五十	commentary
必與	音預	source
不復	扶又反下文夫復同	commentary
姪	大結反	source
娣	大計反	commentary
兩媵	羊證反又繩證反	_
齊漱	爭皆反下皆同	commentary
澣	音浣	commentary
如朝	直遥反下文朝服注朝於君皆同	source
爲繆	居虯反	commentary
必後	胡豆反	source
辟女	音避下辟人雖辟皆同	commentary
敢見	賢遍反下及注同	commentary
使姆	音茂字林亡又反女師也一音母又音亡久反	commentary
郷前	休亮反下文西郷皆同	commentary
接以	依注音捷字妾反勝也下接子同	commentary
謂食	音嗣下注食子食乳皆同	source
射天地	食亦反	commentary
言承	如字徐音拯救之拯	commentary
大古	音泰	commentary
嫡妾	本亦作適同丁歷反	_
一處	尺御反	source
耆	市志反	commentary
爲兒	于僞反下爲改爲大温皆同	source
爲鬌	丁果反徐大果反	commentary
夾囟	音信又思忍反	source
當楣	音眉	commentary
相	息亮反	commentary
孩而	字又作咳戸才反	_
左還	音旋轉也	commentary
辯	音遍下同	commentary
如養	羊尚反	source
褖衣	通亂反	_
適子	丁歷反注及下同	commentary
易諱	以豉反	source
三月之末	一本作子生三月之末	source
申繻	音須	commentary
食子	音嗣注及下文食母同	commentary
勞賜	力報反	commentary
旬	音均出注	source
尊別	彼列反下其別同	_
食食	上如字下音嗣	commentary
男唯	于癸反徐以水反	commentary
女俞	以朱反然也	commentary
鞶革	歩干反	commentary
盛帨	音成	commentary
縁之	于絹反	commentary
裂	音列或音厲	commentary
與	音預	commentary
如厲	音列	commentary
必後	胡豆反	commentary
數日	所主反	commentary
襦	字又作襦音儒	commentary
袴	苦故反	commentary
請肆	本又作肄同以二反習也	_
爲大	音泰	commentary
舞勺	章略反注同	source
而冠	古亂反	commentary
以衣	於旣反	commentary
惇行	如字又下孟反	_
孝弟	音悌	commentary
孫友	音遜注同	commentary
所好	呼報反	commentary
則去	如字	commentary
婉	紆晚反徐紆願反	source
娩	音晚徐音万	commentary
麻枲	思里反	commentary
絲繭	古典反	commentary
織紝	女金反又如林反	commentary
組	音祖	commentary
紃	音巡	commentary
以共	音恭	commentary
絛也	他刀反	_
禮相	息亮反	commentary
謂應	應對之應	source
接見	賢遍反	commentary
爲衒	古縣字本又作御字魚據反	source