喪大記第二十二	鄭云以其記人君以下始死小斂大斂殯葬之大事故以大記爲名	_
卷之十三皆埽	悉報反	_
爲賔	于僞反下爲其爲賔爲主人皆同	commentary
徹縣	音玄注同	commentary
士去	起吕反注及下同	commentary
東首	手又反下注南首同	commentary
北牖	依注音酉舊音容下注牖下放此	commentary
爲墉	音容	commentary
廢牀	仕良反本或作床字	source
褻衣	息列反	_
新朝	直遥反後朝服皆同	source
屬	音燭	commentary
纊	音曠新緜也一音古曠反	source
易動	以豉反	commentary
適寢	丁歷反注同	commentary
正處	昌慮反下同	_
林麓	音鹿	commentary
階梯	他兮反	commentary
簨	恤尹反	source
虡	音巨	commentary
以卷	本又作衮同古本反注同	commentary
屈狄	音闕注同	commentary
玄赬	勑貞反	commentary
襢衣	知彦反	_
稅衣	他亂反	commentary
東榮	如字屋翼也劉昌宗音營	source
三號	戸髙反注同	commentary
捲衣	俱勉反徐紀阮反	commentary
褘衣	音輝	_
以鷩	必列反	source
揄狄	音遥	commentary
以毳	昌銳反	source
東霤	力又反	_
以篋	苦牒反	source
乗車	繩證反	commentary
左轂	工木反	source
之惡	烏路反	commentary
衣尸	於旣反注衣尸同	commentary
以斂	力驗反後不出者皆同	commentary
而去	起吕反	commentary
以袡	而廉反婦人嫁時上服	commentary
人諦	大兮反本又作啼	_
扳	本又作攀普班反一音班	commentary
援	音袁徐于願反	commentary
爲寄	于僞反下皆同下注爲母爲其罷倦皆同	source
徒跣	悉典反	commentary
扱	初洽反	source
衽	而審反又而鴆反裳際也	_
拊心	音撫	commentary
使者	色吏反	commentary
郷其	許諒反	commentary
馮之	皮冰反本或作憑後皆同	source
人袒	大旱反	commentary
說髦	本作稅同他活反徐他外反注同髦音毛	source
人髽	側瓜反	commentary
奉尸	芳勇反注同	commentary
夷于堂	如字夷尸也陳也本或作侇同音移一本作奉尸于堂	commentary
從而	才用反又如字	source
氾拜	芳劒反	_
而免	音問後放此	commentary
拾踊	其劫反	source
裼裘	思歷反	_
之卷	起權反	commentary
出壺	音胡	_
縣之	音玄及下注同	commentary
代更	古行反下同	commentary
罷	音皮	commentary
倦	其卷反	commentary
爲漏	音陋	commentary
給爨	七亂反又七官反下爨鼎同	commentary
爲㪺	音俱水斗也隱義云容四升也	commentary
挈壺	苦結反又音結	_
下君	戸嫁反下成君不相下下大夫同	commentary
照饌	仕眷反	commentary
滅燎	力召反又力弔反	commentary
南郷	許諒反	source
事處	昌慮反	_
以衰	七雷反	source
人爲	于僞反下人爲主爲下注爲君皆同	source
竟内	音境下同	source
輯之	側立反下同斂也	commentary
則去	起吕反後去杖皆同	source
以見	賢遍反	commentary
斂也	力檢反下同	_
以柱	知主反	commentary
近尸	附近之近	_
爲夫人	于僞反下及注妾爲君爲人得並同	commentary
棄杖	本亦作古弃字	_
斷而	丁管反下注斷足瓜同	commentary
大盤	本又作槃歩于反	source
造冰	七報反下及注皆同造猶内也	_
士併	歩頂反注同	commentary
䄠	之善反單也注同	commentary
笫	側里反簀也	commentary
含一	胡暗反	commentary
濡	奴亂反下文同	source
濯	直孝反下文同	commentary
于坎	口感反	commentary
札	側八反	commentary
爛	力旦反	commentary
袒簀	音責	commentary
盛水	音成	_
廣八	古曠反	source
長丈	直亮反	_
深三	尸鴆反	commentary
幠用	荒胡反	commentary
去死	起吕反注同	source
楔齒	桑結反	commentary
角柶	音四	source
綴足	丁劣反又丁衞反下注同	commentary
適室	丁歷反	commentary
管人	如字掌管籥之人又古亂反掌館舎之人也下同	commentary
汲	音急	commentary
不說	吐活反	commentary
繘	均必反汲水綆也	commentary
抗衾	苦浪反舉也	commentary
用盆	蒲奔反	commentary
沃水	烏谷反	commentary
用枓	音主又音斗	commentary
絺巾	勑其反一本作綌去逆反	commentary
挋	音震拭也	commentary
如它	音他下同	commentary
挋拭	音式	commentary
差	七何反淅也注差淅同	source
沐	音木	commentary
甸人	田遍反	source
爲垼	音役鄭注儀禮云塊竈也	commentary
陶人	音桃	source
出重	直龍反	commentary
鬲	音歷	source
煑	諸許反	commentary
西北厞	扶味反隱也舊作扉音非門扉也	_
爨之	七逭反	source
差淅	先歷反	commentary
其潘	芳袁反米汁也	source
差	初佳反	source
率	音律又音類	source
而上	時掌反	commentary
食粥	之育反又音育下同	source
一溢	音逸劉昌宗又音實下同	commentary
莫一	音暮	source
䟽食	音嗣下及下注䟽食皆同	commentary
不盥	古緩反	commentary
於篹	本又作匴又作算悉緩反又蘇管反竹筥也	commentary
以醯	呼雞反	commentary
杯杅	音于	commentary
竹筥	居吕反	commentary
歠	昌恱反	commentary
手飯	扶晚反	commentary
作簨	息尹反徐音撰	_
期之	音基下同	commentary
爲母爲妻	並于僞反下注爲其同	commentary
不與	音預下同	commentary
比葬	必利反	commentary
君食之	音嗣下父之友食之皆同	commentary
不辟	音避	commentary
粱肉	音良梁粱米也	_
以簟	徒點反	commentary
以葦	于鬼反	commentary
有莞	音官又音完	commentary
布絞	戸交反後同	commentary
縮者	所六反	commentary
縞衾	古老反	commentary
九稱	尺證反杜預云衣單複具曰稱後放此	commentary
絞紟	其鴆反後皆同	commentary
縮從	足容反	commentary
連數	色主反	_
見之	賢遍反	commentary
絞一幅	本又作畐方服反	source
爲三	絶句	commentary
不辟	絶句補麥反又音璧徐扶移反	commentary
無紞	丁覽反	source
廣終	古曠反	source
析其	思歷反下同	source
之強	其丈反	source
被識	式志反又音志又音式下同	_
去之	起吕反下注同	source
不倒	丁老反注及下同	commentary
散衣	悉但反	commentary
無襚	音遂	_
複衣	音福	commentary
褶	音牒袷也	commentary
袷也	古洽反	_
袍必	歩毛反	_
不襌	音丹	_
繭	古典反	source
與稅	吐亂反	_
袡	而廉反	commentary
纁	許云反	source
袗絺	之忍反	source
亦爲	于僞又下文則爲之同	source
之篋	苦協反	commentary
不詘	丘勿反	source
綌紵	直吕反	source
便也	婢面反	commentary
大胥	依注作祝之六反下同	commentary
胥樂官	思餘反	commentary
不紐	女九反舊而愼反	commentary
郷左	許亮反	_
士與	音預注同	commentary
爲􁏨	音執本亦作執	commentary
錦冒	莫報反下及注同	_
黼	音甫	source
殺	色戒反徐所例反下及注同	commentary
之裁	才再反注同	source
韜尸	本又作㞵吐刀反下同	commentary
鋪席	普吳反又音敷下皆同	source
巫止	本或作巫止門外門外衍字耳	commentary
主辟	必亦反	commentary
凶邪	似嗟反	commentary
姪	大結反	source
娣	大計反	commentary
長子	丁丈反下同	commentary
服膺	於陵反	commentary
奉之	芳勇反	source
拘之	音俱一音古侯反	commentary
同處	昌慮反	commentary
居倚	於綺反	commentary
苫	始占反	commentary
枕	之鴆反	source
凷	苦内反	_
襢	章善反注同露也	_
障之	音章下同	commentary
柱	張主反	commentary
楣	音眉	commentary
見面	賢遍反	_
適子	丁歷反	commentary
屬目	音燭	_
無辟	音避下注猶辟同	commentary
􁇠	於糾反	source
堊	烏路反又烏各反注同	commentary
禫而	大感反	commentary
作道	音導	commentary
不復	扶又反	commentary
期居	音基下同	commentary
爲母爲妻	並于僞反下爲之賜注爲之則爲並同	source
以上	時掌反	commentary
直君	如字又音值當也	source
先後君	悉見反下胡豆反一音並如字	commentary
夾階	古洽反	source
祝相	息亮反下相止並同	commentary
下正君	戸嫁反	source
屬六	音燭後皆同	source
椑	步歷反	source
四重	直龍反下同	source
水兕	詞履反	source
被之	皮義反下同	_
其厚	戸豆反	commentary
杝棺	以支反	commentary
是差	初佳反徐初冝反	commentary
時僭	子念反	_
金鐕	子南反釘也	_
㭬	陟角反本又作琢	commentary
著	直略反	commentary
小要	一遥反下同	commentary
鬊爪	音舜亂髮下側巧反	commentary
實于緑	音角出注	commentary
小囊	乃剛反徐音託	_
盛之	音成	source
爲簍	魯口反	commentary
用輴	勑倫反	source
櫕	才完反下同	commentary
以幬	音道注同覆也	source
不曁	其器反注同	source
見衽	賢遍反注同	_
猶菆	才工反本亦作叢	source
記參	初金反	_
差	初冝反	commentary
題	音啼	source
湊	七豆反	source
四注	徐之樹反下同	source
差寛	初賣反又初佳反	source
掘地	其越反又其勿反	source
作錞	徒對反又徒臥反又徒猥反	commentary
作埻	依字支允反又支閏反徐都臥反沈都雷反	source
熬	五羔反	commentary
四種	章勇反下及注同	source
八筐	音匡	commentary
魚腊	音昔	source
蚍	音毗	source
蜉	音浮	source
黻三	音弗	source
錦褚	張吕反下同	_
加僞	依注讀爲帷位悲反	source
齊五	如字徐才細反	source
黼翣	所甲反	source
皆戴	丁代反下及注同	commentary
纁披	彼義反徐甫髲反下同	source
戴綏	依注爲緌音𬎼耳佳反下同	commentary
紐	女九反	commentary
揄絞	音遥注同	source
緇	側其反	commentary
及壙	苦晃反	source
惡其	烏路反	commentary
以衣	於旣反下衣以皆同	commentary
以上	時掌反下魚上同	source
車苓	音零	_
縣池	音玄下皆同	_
動揺	音遥一音以照反	commentary
則去	起吕反	commentary
齊象車蓋蕤	絶句一讀以𬎼向下	_
瓜	古華反	source
分	扶問反又皮莧反又夫云反	commentary
廣三	古曠反	commentary
髙二	古報反又如字	commentary
柄長	直諒反又如字後放此	commentary
而從	才用反	commentary
用輴	依注音輇市專反下同王勑倫反	commentary
四綍	音弗	source
二碑	彼皮反	source
御棺	一本作御柩	source
羽葆	音保	source
用國	依注亦作輇市專反王如字云一國所用	source
比出	必利反注同	source
作團	徒丸反	source
曰引	音胤	commentary
爲率	音律	commentary
凡封	依注作窆彼驗反下及注機封同	source
以咸	依注讀爲緘古鹹反	commentary
毋	音無下同	_
譁	音華	commentary
說載	吐活反	source
輓棺	音晩	commentary
繞	而沼反	source
要	一遥反	source
舒縱	子用反下同	source
縱舎	音捨	commentary
有隧	音遂延道也	commentary
爲椷	古咸反一本作緘	_
而上	時掌反	source
抗木	苦浪反徐戸剛反	commentary
五重	直龍反下同	source
容柷	昌六反	_
容甒	音武	source