祭義第二十四	鄭云名祭義者以其記齊戒薦羞之義	source
欲數	色角反下同	source
則怠	大改反	commentary
曰祠	嗣思反	commentary
悽	音妻	commentary
愴	初亮反	commentary
旣濡	本亦作濡音儒	commentary
怵	勑律反	commentary
惕	他歷反	commentary
皆爲	于僞反下文見所爲并注同	commentary
放其	方往反	commentary
致齊	側皆反後不岀者同	commentary
散齊	息但反注同	commentary
所樂	音岳又五孝反	commentary
所耆	市志反注及下並同	_
屈到	屈勿反屈到楚莫敖	commentary
耆芰	其寄反楚人謂菱爲芰	_
僾然	音愛微見貌	commentary
周還	音旋本亦作旋注同	source
愾然	開代反	commentary
闔戸	戸臘反	_
致愨	苦角反	_
敬養	羊尚反	commentary
郷也	許諒反下文郷也郷之注郷之同	commentary
言夫日	音扶本或作言夫忌日	commentary
爲相	息亮反下文同	commentary
不怍	才各反	commentary
奠盎	烏浪反	commentary
齊齊乎	如字舊子禮反	commentary
愉愉乎	羊朱反	commentary
盎齊	才細反	source
繹日	音亦	commentary
儐尸	音賔	source
之忠	如字謂盡中心	source
文王與	音餘	source
樂與	音洛下同	source
尸侑	音又	commentary
仲尼嘗	絶句嘗秋祭	source
奉薦而進	絶句	commentary
其親也愨	絶句	_
趨	音促注及下注皆同	commentary
以數	色角反速也徐音速注同	commentary
子贛	音貢	source
濟濟	子禮反下同	source
漆漆	依注音切下同	_
濟濟者客也	口白反賔客也下客以逺同	commentary
漆漆者容也	羊凶反儀容也下若容以自反同	_
樂成	音岳又五教反	commentary
慌	況往反注及下同一音荒	commentary
惚	音忽注及下同本又作忽	commentary
所當	丁浪反	commentary
一槩	古代反	commentary
比時	必利反徐甫至反注同	commentary
先時	悉薦反又如字	commentary
洞洞	音動下同	source
屬屬	音燭下同	commentary
如弗	本亦作不何休云弗者不之深也	source
勝	音升	commentary
也與	音餘	source
黝	於糾反	commentary
堊	烏路反	source
祝祝	上之六反下之又反又並之六反	source
仿	孚往反	_
佛	孚味反	source
以詘	求勿反注及下幷篇末同徐丘勿反	commentary
敬齊	如字注及下同王徐側皆反	commentary
婉順	憂阮反	commentary
熬也	五報反	_
如奉	芳勇反	commentary
儼	魚檢反	source
恪	苦各反	commentary
既冠	古亂反	_
●子	而樹反	_
敬長	丁丈反下及下注皆同	commentary
為其	于偽反下為其同	_
近於	附近之近	commentary
乎王	于況反	commentary
至弟	音悌下同	commentary
五更	古衡反下更相同	commentary
措諸	七路反	_
序從	才用反注同	commentary
于碑	彼皮反	commentary
袒而	徒旦反	source
鸞刀	力端反	commentary
以刲	苦圭反	source
膟	音律	commentary
膋	力彫反	source
爓祭	音燖	source
泄	息列反	commentary
䐲	直輒反	source
神見	賢遍反一本作神可見則如字	source
曰𤾉	音陽	_
以別	彼列反下同	_
相廵	依注音沿恱専反	commentary
氾說	芳劍反	_
不悖	布內反	commentary
以去	起呂反	commentary
爭	爭鬬之爭	_
有奇	紀宜反	_
邪	似嗟反	commentary
不治	直吏反	commentary
魄也	普白反	commentary
嘘	音虚	commentary
吸	許及反	commentary
斃于	本亦作弊婢世反	source
隂為	依注音䕃於鴆反	_
土壤	如丈反	_
焄	許云反香臭之氣耳	commentary
蒿	許羔反氣烝出貌	source
烝出	之膺反	_
為藨	表驕反又皮表反	_
以為黔首則	其廉反徐又其嚴反黒也黑首謂民也秦謂民為黔首則法也	_
為民	于偽反	_
復加	扶又反	source
逺邇	音爾	commentary
燔	音煩	commentary
燎	力召反又力弔反	commentary
羶	依注音馨許經反後羶薌同	commentary
薌	音香	commentary
見以	依注見作覸音間廁之間徐古辯反	commentary
見間	依注合為覸字音間廁之間	commentary
以俠	古洽反	commentary
甒	音武	commentary
爲藉	在亦反藉田說文作耤	commentary
朱紘	音宏	commentary
秉耒	力内反	commentary
醴酪	音洛	source
齊	音咨本又作齍	commentary
朝之	直遥反注躬朝同	source
犧牷	音全	_
近川	附近之近	source
仞有	音刄七尺曰仞	commentary
大昕	許斤反日欲出	source
使𧖟	才南反	_
奉	芳勇反下及注同	commentary
種	章勇反	source
風戾	力計反燥也	commentary
以食	音嗣	source
蚤	音早本亦作早	source
脃	七歳反	_
氣燥	悉早反	source
惡濕	烏路反	source
旣單	音丹	commentary
奉繭	古典反	source
服與	音餘注同	commentary
副褘	音暉	_
其率	音類又音律又所律反	source
夫人縿	悉刀反下同說文作繅云抽繭岀絲也以此爲旒縿字音所咸反	_
三盆	蒲奔反掩也	source
三掩	本亦作淹徐於驗反又於斂反	_
則易	以豉反下同	commentary
子	如字徐將吏反下及注同	source
諒	音亮下同	source
油然	音由	source
則樂樂則安	並音洛下不樂同	commentary
與爭	爭鬪之爭	_
德煇	音輝	source
言行	下孟反下理行而行皆同	commentary
而措	本亦作錯七故反	commentary
其減	胡斬反又古斬反下同倦也	source
則銷	音消	commentary
有報	依注音襃保毛反下皆同	commentary
能養	羊尚反後皆同	source
言與	音餘	commentary
先意	悉薦反	source
參直	徐所林反	commentary
莅官	音利又音類本又作涖	_
戰陳	直覲反	source
烖及	音災	commentary
於親	本亦作烖及於身	commentary
亨孰	普彭反	commentary
而薦	將見反	commentary
不遺	如字又于季反	commentary
樂自	音岳皇五孝反	commentary
溥之	本亦作敷同芳于反	commentary
而放	甫往反下同至也	commentary
而準	諸尹反平也	_
無輟	張劣反	commentary
斷一	丁管反	commentary
不匱	其媿反下同	source
博施	始豉反	source
惡之	烏路反	commentary
數月	色主反下同	source
瘳矣	丑留反差也	_
頃歩	讀爲跬缺婢反又丘弭反一舉足爲跬再舉足爲步	commentary
不徑	古定反邪也	source
邪	似嗟反	commentary
趨	七俱反	source
於朝	直遥反後皆同	commentary
而弟	音悌下及下注同	commentary
爲之	于僞反	commentary
不併	步頂反徐扶頂反	commentary
車徒辟	音避注同	commentary
鴈行	戸剛反下同	source
所擔	都甘反	commentary
少者	詩照反下同	source
不遺	如字棄忘也一本作匱其媿反	source
而長	丁丈反下文皆同	commentary
爲甸	田見反	commentary
頒禽	音班	commentary
於廋	本又作獀音蒐所求反	_
狩	音獸	source
士卒	子忽反下同	commentary
放乎	方往反	source
食三	音嗣下同	source
五更	古衡反下同	source
大學	音泰下大學汪大卜皆同	_
而酳	音胤又仕覲反	source
巡守	手又反本或作狩	_
于竟	居領反	_
不復	扶又反下文注將復入同	_
舉觶	之豉反	_
見爵	賢遍反	commentary
之施	始豉反	source
卷冕	古本反	source
明知	音智	source
斷其	丁亂反	source
必恐	曲勇反	source
所以語	魚預反	commentary
陶陶	音遥	source
遂遂	本文作燧音遂	commentary
思慮	息嗣反	source
而術	義作述出注	commentary