祭統第二十五	鄭云統猶本也以其記祭祀之本故名祭統	source
五經	吉凶軍賔嘉之五禮	source
神祇	祁之反	commentary
心怵	勑律反	commentary
祐助	音又	commentary
君長	丁丈反下所長同	source
道之	音導	source
其爲	于僞反注爲謂同一音如字	commentary
追養	羊尚反下同	source
者畜	許六反下同	commentary
盡此	徐子忍反下同	commentary
之行	下孟反	commentary
取夫人	七住反	commentary
所共	音恭下文以共皆同	_
芹	其斤反	source
茆	音卯	commentary
蚳	文之反	source
蝝	恱專反	commentary
蜩	音條	source
蔆	本亦作菱音陵	source
芡	音儉	source
榛	側巾反	source
齊盛	本亦作齍與粢同音咨下及注同	source
純服	側其反注及下純冕同	source
以見	賢遍反	commentary
少陽	詩召反	commentary
乃齊	側皆反本又作齋下不出者同	commentary
言齊也齊不齊	並如字下以齊之同	commentary
耆欲	市志反	source
其邪	似嗟反	source
訖其	居乙反止也	source
先期	悉薦反又如字	source
大廟	音泰後大廟皆同	commentary
副褘	音輝	_
圭瓉	才但反	source
祼尸	古亂反	commentary
執紖	直忍反注同徐以忍反	commentary
大夫從	才用反下皆同	commentary
執芻	初俱反	source
宗婦執盎	烏浪反注同	commentary
從夫人	絶句一讀以從字絶句	source
薦涗水	舒銳反徐音歳	commentary
羞齊	本亦作嚌才細反注同	_
爲柄	兵命反	commentary
作絼	直忍反	commentary
槀也	苦老反下同	_
共其	音恭	commentary
盎齊	才細反下盎齊同	_
以樂	音洛下同	commentary
竟内	音境篇内皆同	_
近主	附近之近	commentary
獻之屬莫重於祼	一本無之屬二字	commentary
道之以禮	音導	source
有餕	音俊	source
施惠	始豉反下文注並同	commentary
能知	音智	source
尸謖	所六反起也	_
百官進	依注作餕	_
自卑	如字隱義音必利反	_
以別	彼列反下同	source
見其	賢遍反下同	commentary
脩於廟中也	一本脩作徧	_
徧及	音遍下同	_
積重	直龍反下同	_
凍餧	乃罪反	_
夫人	音扶	source
見之	如字舊賢遍反	commentary
畜積	勑六反	_
本與	音餘下是與同	_
君長	丁丈反下長幼皆同	_
所惡	烏路反	_
見事	賢遍反下皆同	_
之殺	色界反徐所例反下同	_
鋪	普胡反又芳夫反	_
筵	羊然反	_
爲依	于僞反下注爲其皆同	_
于祊	伯更反	_
言詗	徒貢反	_
索祭	所伯反	_
則伸	音申	_
子行	戸剛反注同徐胡孟反	_
之適	丁歷反	_
以瑶	音遥	_
以散	悉但反	_
之差	本又作之等	_
謂酳	音胤又仕覲反	_
有昭	上遥反後放此	_
南郷	許亮反	_
而舎	依注音釋	_
卷冕	古本反	commentary
執校	戸敎反又戸交反又下卯反下同柄也	source
執鐙	音登又丁鄧反豆跗也	commentary
襲處	昌慮反	source
下跗	芳符反	commentary
貴髀	必氏反又必履反	commentary
不重	直龍反	commentary
臂臑	乃報反肱骨也	source
有卑	必利反下及注同與也	source
煇	依注作韗同況萬反又音運下同甲吏也	source
胞	歩交反下同肉吏也	source
翟	音狄樂吏也	source
􁆻	音昬守門者也	_
以見	賢遍反注皆同	source
見此卑	如字舊必利反下同	source
韗磔	知宅反	commentary
曰礿	羊灼反字又作禴	source
夏祭	戸嫁反下注夏者孟夏同	commentary
草艾	音刈	commentary
可芟	所銜反	commentary
給爨	七亂反	_
亨	普彭反徐普孟反	commentary
自名	如字徐武政反下及注自名同	commentary
論譔	音撰	commentary
身比	毗志反謂次比也下及注皆同	source
斟酌	之林反	source
傅	音附徐音賦一音直專反謂傳述	_
著	直略反徐張慮反	commentary
之行	下孟反	source
以見	賢遍反注同	commentary
知足	音智注同	source
孔悝	口回反	commentary
公假	加百反至也注同	source
蒯	苦怪反	source
聵	五怪反	source
襃之	保毛反	_
左	音佐	source
右	音又下啓右并注同一讀此左右並如字	source
難	乃旦反	commentary
奔走	本亦作犇	source
無射	音亦注同	commentary
爲筴	初革反	commentary
猶女	音汝後皆同	commentary
從焉	才用反	commentary
坐殺	才臥反	source
寘之	之豉反	source
厭也	於豔反下同	source
鎬京	胡老反	source
纂乃	子管反	source
侯衎	苦旦反	source
烝	之承反下文注同	source
鉏	仕居反	commentary
耆欲	市志反	source
不解	古賣反	source
休哉	許虯反	source
子圉	魚吕反	source
予女	羊許反注同	source
以辟	必亦反又婢尺反注同明也	source
施于	如字著也	source
彞鼎	以支反	_
猶著	張慮反又直略反下同	source
約	如字徐於妙反	source
劑	子隨反	source
是誣	音無	commentary
不傳	直專反不本亦作弗	source
八佾	音逸	commentary
赤盾	食準反又音允	source
羽籥	羊灼反	commentary