春官宗伯第三僉曰	七潛反皆也	_
曰俞	羊朱反然也李一音由	commentary
女秩	音汝	_
氏姓	如字劉音紙	commentary
大廟	音泰下放此	commentary
隮	本又作躋子兮反升也	commentary
夏父	音甫	_
釁夏	虚覲反	_
鬱人	於物反	_
鬯人	勑亮反	_
秬	其許反李其虛反	_
一稃	音孚	_
鋪之	普吳反又音孚	_
藉之	在夜反	_
守祧	他堯反	_
奄八人	於檢反劉於驗反	_
周爲	于僞反	_
才知	音智	_
三昭	上招反說文作佋	_
少府	詩照反	_
冢塋	音營	_
之長	丁丈反後皆放此	commentary
之稱	尺證反	_
矇	音蒙	source
眡	音視鄭常至反	commentary
瞭	音了又力小反字林同云明也	commentary
杜蒯	如字劉音屠下苦怪反	_
目眹	直忍反本又作䀕或作䀹劉又音睫	_
之瞍	本又作􁄚素口反說文云無目也字林云目有眹無珠子也先久反	_
鎛師	音博	commentary
韎師	戚莫拜反劉李音妹	commentary
味食飲之味	如字又莫介反	_
菋	莫戒反又音味	_
荎	直基反劉直棃反李音姪	_
著	直居反李張慮反	commentary
韎韐	古洽反又音閤	_
籥師	餘若反	commentary
猶繹	音亦祭之明日又祭也字書作釋	_
去籥	起吕反下同	_
鞮	丁兮反許愼云屨也	commentary
鞻	九具反又力具反吕忱云鞮革屨也鞻者靲鞻	commentary
所屝	房味反	_
蹋鼓	徒臘反李吐臘反	_
沓行	他荅反又如字	_
謂楯	食允反又音允	_
菙氏	時髓反	commentary
燋	哉約反	commentary
焌	音俊又子寸反	commentary
問蓍	音尸	_
眂祲	子鴆反李且祍反	_
甸祝	音電後不音者同	commentary
詛祝	側慮反	source
謂祝之	之又反	_
使沮	在吕反沈音敘	_
馮	音憑	commentary
相氏	息亮反注同	commentary
宿	劉息就反一音夙	commentary
離	力計反	commentary
不貣	吐得反或音二	_
巾車	如字劉居覲反	commentary
猶衣	於旣反	_
大宗伯地示	音祇本或作祇下神示地示之例皆放此下卷亦然	_
佐王	本或作左音同	commentary
享之	許丈反後不音者同	commentary
以禋	音因李又音煙	_
以槱	羊九反本亦作楢音同積也	_
燎	良召反	commentary
飌師	音風	_
芃芃	薄工反一音房逢反	_
棫	音域	_
樸	音卜	_
三能	他來反下同	_
圜丘	于權反	commentary
以貍	亡皆反劉莫拜反	source
沈	如字劉直䕃反	source
疈	孚逼反一音方麥反	commentary
共工	音恭	source
句龍	古侯反下同	commentary
厲山	如字本或作烈	source
爲禩	音祀又作祀	_
爲罷	如字一音芳皮反	commentary
披磔	張格反	commentary
亦食此	音嗣下食宗族同	source
少昊	詩照反下少昊同	commentary
曰重	直龍反	source
該	古來反	commentary
蓐收	音辱	source
不見	賢遍反此内不音者同	commentary
四竇	音獨本亦作瀆下同	source
省文	所景反	commentary
磔禳	如羊反	source
及蜡	士詐反	source
百種	章勇反	source
及郵	有牛反	source
畷	音綴井田間道左思吳都賦云畛畷無數又陟劣反	source
以肆	他歷反解骨體	commentary
祼	古亂反	source
以禴	餘若反	commentary
以烝	之承反	source
是祫	户夾反	source
率五	音律又音類	source
含	戸暗反本亦作唅	commentary
襚	音遂	source
凶札	如字又音截	commentary
不縣	音玄	commentary
爲火	于僞反下荀偃爲同	source
以禬	劉戸外反徐古外反	commentary
以更	音庚下同	source
所喪	息浪反	commentary
于澶	善然反	source
曰朝	直遥反注下不出者皆同	source
更遞	音弟	commentary
而徧	音遍下同	commentary
猶朝也	張遥反	commentary
殷覜	他弔反一音他堯反	commentary
竟外	音境	commentary
僭	子念反沈創林反	source
差	初佳反沈初冝反	commentary
閱衆	音恱	_
封疆	居良反	commentary
不別	彼列反	_
昬冠	古亂反	_
脤	上忍反	commentary
膰	音煩	source
見命	如字下士相見同	commentary
以上	時掌反	source
彪	甫休反	commentary
實先	悉薦反下先時同	source
後之	胡豆反	commentary
爲瑑	直轉反	commentary
信圭	音身	commentary
麤縟	音辱	source
愼行	下孟反	commentary
六摰	音至本或作贄	_
鶩	音木	commentary
守介	音界或作兮扶問反	commentary
以繢	胡對反	source
衣之	於旣反	commentary
皮與	音餘	source
神坐	才卧反後神坐放此	commentary
植璧	音值又時力反一音置	source
黃琮	才宗反	source
赤璋	音章	source
白琥	音虎	source
玄璜	音黃	source
混	戸本反本又作崑音昆	_
淪	音倫本又作崙魯門反	_
各放	方往反	commentary
爲制	于僞反	commentary
其中	丁仲反又如字	commentary
令民	力呈反下同	commentary
淫泆	如字本亦作佚	commentary
蕩滌	徒歷反	commentary
邪穢	似嗟反	_
道人	音導	_
急悍	戸幹反劉音旱戚胡板反	_
其種	章勇反	commentary
省牲	本又作眚同息井反後省牲鑊皆同	_
鑊	戸郭反	_
玉齍	音咨下同	_
詔相	息亮反注下同後詔相皆放此	commentary
漑祭	古愛反本或作槪	commentary
亨牲	普庚反	_
不與	音預下同	commentary
載果	音祼古亂反出注小宗伯職放此	commentary
曰儐	必刃反本或作賔同	_
純衣	側其反	_
假祖	音格至也	source
立依	於豈反	source
南郷	許亮反	source
以筴	初革反	_
乃頒	音班	commentary
小宗伯威仰	如字劉五郎反	_
熛怒	必消反	commentary
含樞	昌朱反	source
紐	女九反	commentary
招拒	居禹反沈又音巨	source
汁光	音叶劉子集反	source
之昭	常遥反	source
適子	丁歷反	commentary
毛六牲	戚如字劉莫報反	commentary
苽也	音孤	_
斝彞	音假又音嫁	commentary
蜼	音誄又以水反	source
獻尊	素何反	commentary
著尊	直畧反	source
大尊	音泰	commentary
饎人	昌志反	commentary
視亨	普庚反劉普孟反	commentary
將瓉	才但反	_
之齎	子兮反本又作賫	source
祓社	孚物反劉音廢	commentary
以從	才用反	source
齊車	側皆反	source
則與	音預注則與與其祭與祭與執事同	source
大甸	音田出注下甸役同	commentary
而饁	于輒反劉于法反	source
讄曰	音誄	commentary
鬯渳	亡婢反杜音泯亡忍反李亡辨反	source
大斂	力豔反下及注同	source
九稱	尺證反	commentary
縣	音𤣥	commentary
衰冠	七雷反	source
甫竁	昌絹反李依杜昌鋭反鄭大夫音穿	commentary
腐	房甫反	commentary
脃之脃	七歲反舊作脺誤劉清劣反或倉沒反字書無此字但有膬字音千劣反今注本或有作膬字者則與劉音為協沈云字林有脺音卒脺者牛羊脂膬者耎易破恐字誤案如沈解義則可通聲恐未協脺已下皆非鄭義	commentary
離也	力知反	commentary
肄儀	以志反習也沈音四李又似二反	commentary
肆師牲牷	音全	_
及其祈	祈及注禨同巨既反或旦依反	commentary
珥	而志反注衈同	commentary
刲羊	苦圭反	commentary
夾室	古洽反劉古協反	commentary
職人	劉之弋反戚音弋注樴同	commentary
監門	古銜反	commentary
及果	古亂反下同	source
䰞	音煑	commentary
相治	息亮反下相其禮及注同	source
爲剽	芳遥反或祊遥反	commentary
徽識	式志反又昌志反	source
匪罋	於貢反	source
公食	音嗣下同	commentary
誤與	音餘下侯與同	commentary
之衰	七雷反注同	commentary
不中	丁仲反注同	commentary
爲夫	于僞反下爲取同	commentary
師甸	音田下大甸同	commentary
類造	七報反注造猶同	source
牧之	戚音目劉音茂	commentary
表貉	莫駕反鄭音陌後表貉皆同	commentary
蚩蚘	音尤	commentary
之芟	色銜反	commentary
載柞	側百反	commentary
獮	思淺反	commentary
及禜	音詠	commentary
酺也	音蒲又音歩	_
鬱人焦中	子遥反劉似消反本又作鐎音同李又即脩反	_
造冰	七報反下同	commentary
士併	薄冷反	commentary
䄠	章善反沈又音但	_
第	側几反	commentary
遂貍	亡皆反	source
遣奠	弃戰反	commentary
斝之	古雅反	commentary
之嘏	古雅反	commentary
王酳	侯吝反又音胤	commentary
脯㸋	音煩	commentary
鬯人社壝	唯癸反劉欲鬼反	_
大罍	音雷或郎追反	commentary
壇墠	音善或音禪	_
禜門	音詠	commentary
用瓢	婢遥反	commentary
齎	音齊在兮反杜音資	commentary
營鄼	作管反	_
作剽	匹召反	source
蠡也	力兮反或郎戈反	commentary
割去	起吕反	commentary
柢	音帝	commentary
用脩	音卣羊久反又音由中罇也	commentary
凡祼	音埋岀注	source
用槪	古愛反	source
凡疈	孚逼反	source
用散	素旱反注及下注同	source
獻象	素何反	source
蚌	歩項反	commentary
曰合	音含本亦作含	source
將	如字本又作漿	source
設斗	音主注同	commentary
給淬	七内反	source
共介	音界	commentary
被之	普皮反又皮寄反	source
爲執	于僞反	commentary
神與	音餘	source
畛於	之忍反致也	commentary
某父	音甫本又作甫	source
雞人用􁇠	於紏反	_
嘑旦	火吳反本又作呼	commentary
以􁅭	古弔反	source
以警	音景	source
朝服	直遥反	source
比於	毗志反	source
禳	如羊反	source
司尊彞泲之	子禮反下同	_
醴齊	才計反下文注除齊語齊人並同	commentary
兩獻	本或作戲注作犧同素何反注及下注汁獻同	commentary
斝彞	音嫁	commentary
兩著	直畧反注同	commentary
朝享	直遥反注朝享朝受政猶朝及下注朝用同	commentary
蜼	音誄又以水反	source
兩大	音泰注同	commentary
酌盎	烏浪反	commentary
玉琖	莊産反	commentary
爲酢	才洛反	source
彞卣	音酉又音由本亦作攸	commentary
蛇虺	上虵下許偉反	commentary
射隼	食亦反下荀尹反	source
禺屬	音遇劉音隅	commentary
卬鼻	魚丈反又五剛反	_
獻酌	素何反司農音儀	commentary
涗酌	舒銳反李一音雪	commentary
脩酌	直歷反注同	commentary
爲數	音朔下同	commentary
爲齍	子兮反	commentary
挩飾	舒銳反本或作拭	_
勺而	上酌反下同	commentary
齊和	胡臥反	commentary
醴醆	莊産反	commentary
粢	才計反記作齊音同	commentary
緹	音體	commentary
舊澤	音亦下曰醳音同	source
摩莎	素何反	commentary
去滓	起吕反	commentary
浩酒	胡老反或古老反	commentary
司几筵彤	徒冬反	_
莞	音官又音丸	commentary
藻	本又作繅音早	commentary
朝覲	直遥反下注來朝朝者同後朝覲朝見之類放此	commentary
黼	音甫	commentary
依	於豈反下及注同	source
南郷	許亮反下及注同	commentary
紛純	章允反劉之閏反司農音均下同	commentary
爲王	于僞反下爲布同	commentary
爲豳	彼貧反	commentary
縁也	恱絹反	commentary
藻率	音律下同	commentary
馮玉	皮冰反	_
蒲蒻	音弱	source
編以	必緜反	commentary
繢	胡内反	commentary
柔嚅	本或作懦又作擩同如兖反	_
甸役	音田注同	commentary
其柏	鄭音椁劉依司農音迫	commentary
用萑	音丸	commentary
每敦	音道劉音疇	_
藏中	才浪反	commentary
曰燾	音導	commentary
翌日	音翼劉音育	commentary
於祊	補庚反	_
天府守藏	手又反下才浪反	_
世傳	直專反	_
玉鎭	珍忍反又音珍	_
作瑱	他見反	source
琬	於阮反	commentary
琰	以冉反	source
天球	音求	commentary
賁鼓	扶云反	_
兊之	徒外反	source
垂之	如字劉音瑞	commentary
見衣	賢遍反	_
之治	直吏反下及注同	source
中	丁仲反下注同	commentary
沃盥	音管	commentary
朝于	直遥反	source
者與	音餘	commentary
數榖數	上所主反下所具反	_
下能	他來反	commentary
而上	時掌反	source
典瑞之藏	才浪反	_
以見	賢遍反下見於時見殷見同	commentary
繅藉	在夜反下同	source
以朝	直遥反注及後放此	commentary
韋衣	於旣反	commentary
薦申	如字下同一音箭	_
謂臿	初洽反或初輙反	_
杼上	除汝反	source
信圭	音身	commentary
瑑圭	直轉反	source
以覜	他弔反	commentary
有圻	魚斤反	source
鄂	魚各反	commentary
有邸	丁禮反又音帝	source
著其	直畧反	commentary
僢而	昌絹反	commentary
同柢	音帝	_
以肆	如字又他歷反注同	commentary
以挹	於十反又於集反	commentary
䘏彼	音瑟又作邲	commentary
取殺	色界反劉色例反下同	source
邸射	食亦反注同	commentary
以造	七報反	source
射剡	以冉反或囚冉反	commentary
度其	待洛反下度地度日同	source
地中	如字劉丁仲反	commentary
徴守	劉手又反注徴守同	_
王使之	所吏反下今使者亦王使於使者皆同	commentary
闓府	音開	commentary
袤	音茂	commentary
駔圭	音祖	commentary
以斂	力驗反注同	commentary
令汁	力呈反下令爲同	commentary
和難	乃旦反注同	commentary
及郯	音談	commentary
叚嘉	音遐本又作瑕亦作假皆同	_
結好	呼報反注同	commentary
易行	下孟反注同	commentary
除慝	吐得反	commentary
飯玉	扶晩反注同	commentary
含玉	戸暗反	commentary
柱左	張注反	commentary
右顚	如字儀禮作齻音同	_
典命樊纓	畔干反	_
介牢	音界	commentary
適子	丁歷反	commentary
則下	遐嫁反	commentary
射姑	音亦	source
司服鷩	必滅反劉府弊反	_
毳	昌銳反劉淸歳反	commentary
希冕	本又作絺陟里反劉猪履反注下皆同	source
不窋	張律反	source
諸盩	直留反或音胄	source
裨衣	婢支反又方支反	_
罽衣	居例反	commentary
作繢	胡對反	commentary
作黹	張里反	commentary
希刺	七亦反劉七賜反沈此擊反下同	commentary
以韎	劉音妹又莫拜反	_
衣韎	於旣反	_
之跗	方符反又音附	_
注	之樹反	commentary
緹衣	音體戚音提	_
眂朝	音視	_
凡甸	音田注同	_
斬衰	七雷反下皆同	commentary
齊	音咨	source
此近	附近之近	source
作􁃌	音弁	commentary
爲天	于僞反下及注除爲害一字皆同	commentary
滑易	以豉反	source
去其	起吕反下同	commentary
縞冠	古老反劉剛操反	commentary
其齊	側皆反注士齊同	source
有	音儒本亦作𥜗	source
而屬	音燭	commentary
是廣	古曠反後廣袤同	source
其袪	起吕反	commentary
以上	時掌反	_
侈之	昌氏反	source
斂衣	力驗反	commentary
廞衣	虚今反	commentary
典祀而蹕	音畢	_
遮列	章奢反	source
令入	力呈反	commentary
守祧􁇠	於糾反司農音幽	commentary
堊	烏路反或烏洛反本或作惡同	commentary
其隋	許恚反劉相恚反	commentary
世婦比其	本亦作庇鄭毗志反注及下同司農匹氏反劉芳美反沈又上二反	_
齍盛	音咨下文同	source
相外	息亮反	_
朝莫	音暮下同	commentary
而呵	胡何反	_
譴也	弃戰反	commentary
内宗佐傳	直專反注同	_
則從	才用反	source
外宗羞齍	音咨	_
不與	音預注同	commentary
冢人夾處	古洽反劉古協反	_
亦併	薄令反	source
別尊	彼列反	_
請度	待洛反注量度同	source
之窆	彼驗反又補鄧反	source
去碑	起吕反	commentary
以咸	本又作緘同古鹹反	commentary
巾車	如字劉居覲反	commentary
猶語	魚據反下同	source
俑者	音勇	source
以涖	音利又音類	source
職喪贈賵	芳鳳反	_
齍號	音咨	commentary
宗伯下大司樂瞽宗	音古瞽宗殷學	_
命夔	求龜反	_
育子	音胄本亦作胄	_
泮宫	音判本亦作頖同	_
興道	許應反劉虛甑反注同下音導	source
諷誦	方鳳反	commentary
以剴	古愛反劉古哀反	commentary
倍文	音佩	commentary
大卷	大劉皆音泰戚如字卷音權又眷勉反又居遠反沈又居勉反	commentary
大㲈	上昭反	commentary
大濩	戸故反	commentary
共財	音恭	commentary
能殫	時戰反	_
傅土	音孚或音附	_
其邪	似嗟反	commentary
以說	音恱	commentary
其長	如字	commentary
上生	時掌反後上生皆同	source
去一	起吕反下文去樂及注同	commentary
度律	待洛反	source
謂徧	音遍	commentary
物鬽	眉兾反	source
羽臝	力果反下臝物同	commentary
戛擊	居八反劉古八反	source
鳴球	音求	commentary
搏	音博	source
拊	芳甫反	commentary
鼗	徒刀反	source
柷	昌六反	commentary
敔	本又作梧魚吕反	source
以閒	閒厠之閒	commentary
牄牄	本又作蹌七羊反	_
於予	上如字劉音烏下羊汝反	_
效應	應對之應後皆同不更音	commentary
夏正	音征	commentary
大蔟	音太下七豆反下同	commentary
四竇	本又作瀆同音獨	commentary
樂與	音餘	commentary
𬎼賔	人誰反	_
函鍾	胡南反函鍾林鍾也	commentary
中吕	音仲亦如字後同	_
姜嫄	音元本亦作原	commentary
所妃	音配本亦作配	commentary
閟宫	音祕	_
無射	音亦注下同	commentary
夾鍾	古洽反	commentary
圜鍾	于權反	commentary
被也	皮寄反	commentary
介物	音界	commentary
大蜡	七嫁反	source
易致	以豉反	commentary
孔竅	苦弔反	source
蛤蟹	古荅反	commentary
之分	扶問反	source
之知	音智	commentary
爲畜	許又反下同	commentary
魚鮪	于軌反	commentary
不淰	音審	commentary
不矞	休律反本又作獝亦作同	source
不狘	休越反	commentary
爲角	如字古音鹿	source
爲徴	張里反下同	_
靁	音雷	source
九㲈	依字九音大諸書所引皆依字	commentary
崐崘	本又作混淪各依字讀	commentary
而祼	古亂反	commentary
嚳	苦篤反	commentary
大辰	如字劉音泰	commentary
輿鬼	音餘本亦作與	source
辟之	音避下同	source
宿縣	音玄下樂縣之類皆放此	source
屍出	音尸本亦作尸	_
騶虞	側留反	source
召南	上照反下召南同	commentary
挾矢	子協反又音協	commentary
三侑	音又勸也	_
敗楚	必邁反	source
城濮	音卜	commentary
大傀	劉九靡反舊音怪說文以爲傀偉之字解引此文字林公回反李一音杜回反	source
㑹稽	古外反	_
沂山	魚依反	commentary
雍州	於用反	commentary
奔霣	于敏反	commentary
猶繹	音亦	source
大札	側八反鄭音截	source
令弛	式氏反	commentary
哀樂	音洛	source
廞樂	許金反	source
興也	許應反後皆放此	commentary
鎛師	音博	source
樂師幼少	詩照反	_
舞勺	章畧反	commentary
帗	音拂一音弗	source
作䍿	音皇	commentary
析羽	星歷反下同	commentary
氂牛	舊音毛劉音來沈音狸或音茅字或作犛或作斄皆同	commentary
旱暵	呼旦反	commentary
趨以	劉淸須反	commentary
采齊	本又作薺徐私反	_
朝廷	直遥反下同	commentary
作跢	倉注反	commentary
鼓陔	改才反	commentary
撞黃	直江反	commentary
采蘋	音頻	commentary
采蘩	音煩	commentary
毋怠	音無下同	source
視瞭	音了	commentary
令相	息亮反注及下同	source
冕見	賢遍反下注同	commentary
饗食	音嗣下注䟽食同凡言饗食皆放此	source
遂倡	昌亮反	commentary
治訟	直吏反	commentary
大胥之版	音板	_
之酎	直救反	commentary
適子	丁歷反	source
以上	時掌反下六上同	commentary
舎采	音釋下音菜注同	_
䟽食	所居反劉音蘇	commentary
以下	戸嫁反	commentary
曲折	之設反	commentary
爲大	于僞反	commentary
不紕	匹毗反劉博雞反	commentary
比樂	劉如字下同比校也杜毗志反次比也鄭大夫匹婢反具也	source
爲庇	匹婢反	_
陳數	所主反	commentary
大昕	音欣	commentary
小胥鱑	古橫反本或作觥同	_
兕	徐履反	commentary
其觩	巨樛反	source
而撻	吐達反	commentary
抶也	勑乙反又勑栗反	source
荆扑	普卜反	commentary
士犆	音特本亦作特	_
筍	息允反	commentary
簴	音巨	_
去其	起吕反下同	commentary
繁纓	歩干反	commentary
以朝	直遥反	commentary
辟王	音避	commentary
爲堵	丁古反	commentary
大師匏	白交反	_
玄枵	虛驕反	source
娵	子榆反	commentary
訾	子斯反	source
大梁	如字劉音泰	commentary
降婁	戸江反	source
貿處	音茂	source
取妻	七喻反	commentary
土塤	虚袁反	commentary
曰興	虚應反注皆同	commentary
治道	直吏反下治功皆同	commentary
言鋪	普吳反又音孚	commentary
爲之	于僞反下爲之爲作皆同	source
歌邶	歩内反	commentary
知仁	音智	source
擊拊	音撫	source
鼓􁇭	音胤小鼓也	commentary
道	音導	source
引之引	並音胤	commentary
授將	子匠反下同	commentary
士卒	子忽反下同	commentary
大呼	火故反	commentary
數怒	所角反	commentary
之行	下孟反下同	commentary
小師摇之	音遥本亦作摇	_
飴	以之反	commentary
餳	辭盈反李音唐	source
漆筩	音動	commentary
有椎	直追反	source
六空	音孔	commentary
箎	音馳	commentary
􁌀	音狄	commentary
併兩	薄冷反	source
令奏	力呈反	source
應鼙	薄西反	source
喪與	音預	source
其和	戸臥反注同	commentary
錞于	音淳本或作淳	source
瞽矇世奠	音定	_
繫	戸計反注同	commentary
以刺	七賜反	commentary
瞍賦	素口反	commentary
德行	下孟反	source
怵懼	勑律反北本作休	source
眡瞭擊頌	衆家不音當依字戚音容	_
相瞽	息亮反注同	commentary
鼜	音戚	source
愷樂	音洛	commentary
疾數	音朔	source
典同聲䃂	古本反或胡本反	_
陂聲	彼義反	commentary
聲韽	劉音闇又於瞻反鄭於貪反戚於感反李烏南反	source
侈聲	昌氏反又式氏反	commentary
筰	側百反	commentary
弇	沈戚音掩劉於驗反	commentary
甄	音震注同	commentary
作硍	音艱又苦耕反字林音限云石聲	commentary
鏗	苦耕反	commentary
鎗	初衡反劉初耕反	commentary
唶唶	側百反	commentary
短罷	皮買反字或作矲音同桂林之間謂人短爲矲矮矮音古買反	commentary
䳺	烏南反	commentary
當䠋	音婢李又孚葵反一音豐巳反或音蒲年反	_
正傭	勑龍反	commentary
形大上	大音泰下形大下大厚同舊菟佐反上音時掌反	commentary
飛鉆	張林反又其廉反戚或音沾劉又渠金反說文云鐵鋷也一曰膏車鐵鉆銸音竹渉反	commentary
涅	乃結反劉其兼反	commentary
鴻殺	色介反舊色例反	commentary
約也	舊如字戚於敎反	commentary
掉也	徒弔反劉奴較反	commentary
之齊	才計反注同	source
廣	古曠反	commentary
長也	直亮反	source
磬師敎縵	莫半反杜音慢	_
學操	七曹反	commentary
鍾師夏納	本或作納夏	_
齊夏	側皆反本又作齋	source
祴夏	音陔古哀反	commentary
鷔夏	五羔反劉五到反	_
使臣	色吏反	commentary
與聞	音預	commentary
繁遏	於葛反	_
執傹	音競詩作競	_
穰穰	如羊反	_
合好	呼報反	_
和之	胡臥反	commentary
笙師龡	昌垂反	_
竽	音于	commentary
舂牘	音獨或大録反	source
七空	音孔下同	commentary
髤	香牛反或七利反	commentary
鞔之	莫干反	commentary
鎛師以鼖	扶云反	_
將趨	左傳作掫音莊九反杜注云行夜	commentary
籥章豳	彼貧反注邠同	_
蒯	苦對反劉苦壞反	commentary
桴	音孚	source
伊耆	又作帆􁆃二皆音耆	commentary
中春	音仲下同	source
以樂	音洛	commentary
田畯	音俊	source
饁	于輒反劉于法反	commentary
而索	色白反	commentary
爲其	于僞反	source
勞農	力報反	commentary
穫稻	戸郭反	source
躋堂	子兮反	_
無疆	居良反	commentary
鞮鞻氏曰任	音壬下同	_
典庸器博選	胥兖反	_
從者	子容反	source
爲鐻	音距舊本作此字今或作虡	commentary
大卜三􁎂	音兆亦作兆	_
之舋	舊許靳反沈一依聶氏音問云依字一作璺璺玉之坼也龜兆文似之占人注同	source
鏬	劉火嫁反又音呼坼之呼	commentary
謂繇	直又反下同	commentary
又重	直用反	source
坼也	勑白反	commentary
曰濟	節細反又才禮反	commentary
曰圛	音亦	commentary
曰蟊	音濛劉莫溝反沈音謀	commentary
揲	時設反劉音舌	commentary
虙	音服	_
戲	本又作虧音羲	source
重之	直龍反	source
三􁎃	音夢本多作夢	_
觭夢	居綺反注掎同又紀冝反杜其冝反	commentary
咸陟	如字或音得	source
作緷	胡本反字林云大束也說文音運云緯也聶音徽	_
爲煇	音運	source
視祲	子鴆反	source
曰瘳	勑留反	source
以命龜	命亦作令	source
謂菑	音災	_
見吉	賢遍反	source
鮒也	音附左傳作魴	source
演其	以善反	commentary
視髙	音示下同	commentary
冢適	丁歷反	commentary
竟界	音境	commentary
疆	居良反	commentary
鄆田	音運	commentary
骨近	附近之近	commentary
令可	力呈反	commentary
爇也	人恱反	commentary
龜燋	哉約反	commentary
西塾	音孰舊音育	commentary
卜師謂與	音餘	_
辨龜	如字劉皮勉反	source
左倪	五計反又五未反	commentary
後弇	於檢反	source
龜人繹	音亦	_
果	魯火反注臝同	commentary
靁	力胃反又如字	commentary
龜郤	起畧反	_
乾解	音蟹一音佳買反	source
釁龜	許靳反	commentary
□氏	本又作菙同時髓反	_
燋	哉約反李又粗堯反一音哉益反	commentary
契	苦計反劉苦絜反	commentary
薪樵	在消反	commentary
楚焞	吐敦反又徒敦反又在悶反又祖悶反一音純李一音祖館反	commentary
謂炬	其呂反	commentary
焌	音俊又存悶反又祖悶反李祖館反	commentary
戈鐏	存悶反劉祖悶反	commentary
契柱	張主反	commentary
占人八簭	音筮	_
龜長	如字下同	commentary
則𣪠	音係	_
以比	毗志反一音必履反	commentary
中否	丁仲反	commentary
簭人巫更	九巫皆音筮出注	_
巫比	毗志反注同	source
僉也	七亷反	commentary
不說	音悅下同	source
相簭	息亮反注同	commentary
者與	音餘	commentary
占夢	本又作㝱音同	commentary
建厭	於琰反	commentary
休王	于況反	commentary
倮	魯火反	commentary
而轉	如字又張戀反	commentary
入郢	以井反劉餘政反	commentary
有適	直革反	commentary
噩	五各反注愕同	commentary
覺時	古孝反下同	source
寤	本又作□五故反	commentary
幾終	如字又音祈	commentary
乃舎	音釋注舎萌同	_
萌	亡耕反	commentary
去故	起吕反	source
始難	戚乃多反劉依杜乃旦反注以意求之儺字亦同	commentary
磔	陟百反	commentary
禳	如羊反	source
眡祲十煇	音運	_
炁也	音氣本亦作氣	_
曰鑴	鄭許規反劉思隨反或下圭反	commentary
曰瞢	亡鄧反	commentary
曰隮	子兮反	commentary
反郷	許亮反	commentary
如暈	音運本亦作煇音同	_
白虹	音洪又古巷反劉古項反	commentary
則弊	必世反下注同	source
斷	丁亂反	commentary
大祝六祝	之秀反後除大祝宗祝諸官皆同以意求之	_
永長	如字	commentary
遠罪	于万反	_
曰造	七報反注下皆同	commentary
禬	戚古外反劉音㑹	commentary
禜	音詠	commentary
祈嘄	音叫劉音禱	commentary
爲有	于僞反	commentary
號	戸羔反	commentary
呼	火故反	commentary
作見	賢遍反	commentary
是禡	莫駕反	source
縈社	烏營反	_
炤炤	章摇反	commentary
瀐滅	子廉反	commentary
四曰㑹	如字注同	_
禆	婢支反	commentary
諶	市林反	source
蒯	苦怪反	commentary
聵	五怪反	commentary
在難	乃旦反	commentary
自佚	音逸	commentary
德行	下孟反	source
閔天	音旻武巾反	commentary
不憖	魚覲反	source
嬛嬛	求營反	commentary
在疚	九又反	source
尼父	音甫	commentary
奐焉	音喚	source
九京	音原	commentary
齍號	音咨	source
美稱	尺證反	source
大武	如字劉音泰	commentary
剛鬣	力輒反	source
香其	音基	_
嘉䟽	所魚反劉音蘇	commentary
衍祭	音延	commentary
炮祭	百交反兼也劉依司農白交反	commentary
擩祭	而泉反一音而劣反劉又而誰反	source
繚祭	音了劉音料	commentary
共祭	音恭注同	commentary
虞芮	人劣反又而歳反下同	commentary
爲坐	才卧反	commentary
從持胏	劉沈皆子容反今本或無持字從則如字	_
禮殺	色界反劉色例反	commentary
左郤	去逆反又起略反	_
執食	音嗣	commentary
猶徧	音遍下同	commentary
九􁅛	音拜下同	commentary
䭫首	音啓本又作稽	_
振動	如字李依本夫音董杜徒弄反今俀人拜以兩手相擊如鄭大夫之說蓋古之遺法	commentary
竒􁅛	紀冝反	commentary
褒􁅛	音報	_
享右	音又勸也	commentary
相近	附近之近	source
哀慟	徒弄反	commentary
倚拜	於綺反下同	commentary
撎	於立反即今之揖	commentary
爲事	于僞反	commentary
使者	所吏反	commentary
朝獻	直遥反	commentary
大禋	音因	commentary
司烜	況彼反	source
爲祊	必庚反	commentary
隋釁	許規反又思恚反後同	commentary
右亦	音又	commentary
令皐	臯音嘷戸髙反劉戸報反	commentary
爲卒	劉子忽反	commentary
噑呼	火故反	commentary
相尸	息亮反下同	commentary
渳	彌爾反	commentary
相飯	扶晚反	commentary
賛斂	力驗反	_
付練	付音附出注	commentary
復	他兮反	commentary
猶語	魚據反下同	commentary
祓社	芳弗反劉音廢	commentary
以從	才用反一音如字下注同	commentary
舎奠	音釋一音赦	_
山川與	音餘	source
小祝彌烖	依注音敉亡爾反下注同	_
遠辠	于万反	_
熬	五羔反	commentary
爲名	音銘下取名同	source
緽末	勑貞反	_
竹杠	音江	commentary
重木	直龍反下同	source
粥	之六反又音育	commentary
盛以	音成	source
二鬲	音歷	commentary
可別	彼列反	_
識識	並傷志反一讀下識如字	source
斯盡	津忍反	commentary
蚍	音毗	commentary
蜉	音浮	commentary
四種	章勇反下同	commentary
西坫	丁念反	commentary
道齎	音咨	commentary
遣奠	弃戰反	source
作禩	音祀	commentary
無令	力呈反下令可同	commentary
喪祝爲披	彼寄反下同	_
倡帥	昌亮反	commentary
傾戲	音虧	commentary
菆塗	才官反	source
龍楯	勑倫反	_
及朝	直遥反注皆同	commentary
御匶	音舊	source
離其	力智反下同	commentary
飯於	扶晚反	commentary
還車	音旋一音回	commentary
郷外	許亮反	commentary
執翿	音導	commentary
與更	音庚	commentary
說載	吐活反注同劉詩恱反	commentary
去棺	起吕反	commentary
四歰	所甲反本亦作翣	commentary
安錯	七故反	commentary
便其	婢面反	commentary
窆	彼驗反劉補鄧反	commentary
桃厲	劉音例記作茢黍苕穰也音例亦音列	commentary
惡之	烏路反	source
亳社	歩博反	commentary
而棧	劉才産反一音士諫反	source
甸祝表貉	莫駕反注禡同	_
甸以	音田下文同	commentary
舎奠	音釋下同	_
乃屬	音燭	commentary
饁	于輒反	source
禂牲	音誅一音禱	commentary
別其	彼列反	_
爲馬	于僞反下同	source
今侏	音誅字林音朱	commentary
司巫巫尪	烏黃反	_
共匰	音丹	commentary
及蒩	子都反	source
爲鉏	子都反下同	commentary
鉏藉	慈夜反下同	commentary
租飽	劉上音緅又音卷下音苞又音弭沈租音子餘反	commentary
茅裹	音果	commentary
爲神	于僞反	commentary
刌茅	音忖	commentary
守瘞	於例反	commentary
下禓	音傷	_
男巫望衍	依注音延	_
爲之	于僞反	source
爲矰	音曽	_
彌兵	與弭同及敉皆亡氏反	commentary
女巫上巳	音祀	_
旱暵	呼旱反	source
繆公	音穆	commentary
縣子	音玄	source
暴巫	蒲卜反	commentary
大史之治	直吏反下及注其治同	_
爲王	于僞反下爲有同	commentary
厎日	音旨	_
于朝	直遥反下同	commentary
攷焉	音考	source
爭訟	爭鬪之爭	commentary
則辟	婢亦反劉芳益反注同	commentary
抵冒	丁禮反	commentary
中數	所主反下同	commentary
作叶	音協	commentary
爲汁	音執又音協劉子集反	commentary
與大師	音泰注大師同	commentary
抱式	劉音勑今俗音如字	source
焉知	於虔反	commentary
夾日	古洽反劉古協反	source
當先	悉薦反	commentary
遣之	弃戰反注同	commentary
其行	下孟反	commentary
舎算	音釋	_
以盛	音成	commentary
中則釋	丁仲反	commentary
於竟	音境	commentary
小史奠	音定	_
繫世	户計反注同	commentary
昭穆	如字或作巶音韶	commentary
校比	毗志反	commentary
馮相氏	音憑下息亮反	commentary
以㑹	如字注同	_
以見	賢遍反下皆同	commentary
南譌	五和反	commentary
直某	音值	commentary
保章氏文識	音志又音試又如字下同	_
運	本又作煇又作暈音同	commentary
朓	他了反晦而月見西方	commentary
側匿	女力反劉吐則反朔而月見東方曰側匿亦名肭肭女六反	commentary
有分	扶問反注同	source
參爲	所林反	commentary
娵訾	上子須反下子斯反	commentary
降婁	戸江反	commentary
彗	似歳反又息遂反	source
孛	音佩	commentary
之相	息亮反下同	source
内史八柄	本又作枋兵病反	_
王治	直吏反下同	commentary
興父	音甫	commentary
逖	吐歷反	commentary
王慝	吐得反	commentary
食九	音嗣下同	commentary
牘也	音獨	commentary
外史令下	戸嫁反	_
之乗	繩證反	_
檮	徒刀反	source
杌	五忽反	commentary
三墳	扶云反	commentary
使于	所吏反注同	commentary
御史之治	直吏反注及下凡治同	_
數凡	所主反	_
見在	賢遍反	commentary
巾車錫	音陽	_
樊纓	歩干反下同	commentary
二斿	音留	commentary
鞶	歩干反	commentary
三重	直龍反	commentary
罽	居例反	commentary
爲縿	所銜反又所廉反	commentary
則屬	音燭	commentary
大旂	其依反	commentary
以賔	如字劉沈方刃反	commentary
婁頷	尺感反	commentary
率以	音律又音類	commentary
以朝	直遥反注皆同	commentary
龍勒	如字戚音尨	commentary
條纓	依注作絛他刀反	commentary
鞔	莫干反	source
前樊	依注作翦子踐反淺也	commentary
鵠纓	戸篤反	source
重翟	直龍反注同	commentary
朱緫	作動反	commentary
厭翟	於渉反注同	commentary
繢	戸對反	commentary
鷖	烏兮反劉烏計反	commentary
坐乗	繩證反下坐乗皆同或如字	_
爲䌆	戚云檢字林蒼推及說文皆無此字衆家亦不見有音者唯昌宗音廢以形聲㑹意求之實所未了當是廢而不用乎非其音也李兵廢反本或作緦恐是意改也	commentary
作繄	烏兮反	commentary
著馬	直略反	commentary
兩鑣	表驕反	commentary
幨車	昌廉反	commentary
幢容	本亦作潼詩注作童皆音同	_
衡輨	劉音管一音胡瞎反	commentary
謂蔽	劉音弗下及文並同一音必世反	commentary
見於	賢遍反下同	commentary
去飾	起吕反下去戈去毛同	commentary
有握	劉音屋下馬皆作幄烏學反沈云劉音非	commentary
軿車	薄經反	commentary
連車	音輦本亦作輦	_
組	音祖	commentary
輓	音晚	commentary
有翣	所甲反	commentary
從容	七容反	commentary
爲輇	市專反	commentary
爲翳	烏帝反	commentary
爲䭷爲	並音獵䭷或音毛	_
五乗	繩證反下五乗同	_
犬䄙	莫歷反	_
尾櫜	沈音羔劉姑道反	commentary
謂蠃	魯火反劉又音果	commentary
覆笭	力丁反劉又音泠	commentary
爲揟	本又作偦同思如反	source
之弢	吐刀反	commentary
之縁	恱絹反下同	commentary
攝菔	音服	_
虎賁	音奔	commentary
子釗	古堯反又音昭	commentary
棼蔽	扶云反	commentary
堊車	烏路反又烏洛反	source
爲薠	扶文反	source
作􁍱	音揔又音藻李一音倉㑹反	commentary
雚	音丸	commentary
髤飾	香求反	commentary
爲	音次	source
爲桼	音七	commentary
垸之	胡翫反	source
豻䄙	五旦反胡犬也	_
此禫	直感反	commentary
夏篆	音瑑直轉反	commentary
縵	莫干反	commentary
棧車	才産反又仕板反	commentary
有約	如字又於貌反下同	commentary
方箱	息羊反	commentary
散車	素旱反	commentary
輜車	側其反	source
有沽	音古	commentary
入齎	音咨	commentary
以償	時讓反	commentary
遣車	弃戰反注同	commentary
從車	才用反注同	commentary
弊車	婢世反	commentary
不任	音壬	commentary
以和	胡卧反下相應和同	source
警衆	音景	commentary
爲軨	音零劉音領	_
典路用說	書銳反舎車也注及下駕說并注同	_
有朝	直遥反下同	commentary
趣馬	倉口反	commentary
贅路	章銳反又作綴張衞反	commentary
左塾	音孰	source
上計	時掌反	commentary
屬車	音燭	source
路從	才用反注及下注同	commentary
車僕之萃	七内反副也下及注同	_
廣車	古曠反注同	commentary
苹車	薄經反又薄田反	commentary
輕車	遣政反注同	commentary
橫陳	直刃反下同	commentary
猶屏	并領反又薄經反	commentary
公喪	息浪反	commentary
四十乗	繩證反下千乗乗車同	_
爲軿	薄經反	commentary
司常爲旜	之然反	_
鳥隼	息允反	commentary
爲旟	音餘	commentary
爲旐	音兆	commentary
爲旞	音遂	commentary
徽識	式志反又音志又昌志反下同	commentary
所被	普皮反又皮寄反	commentary
著絳	丁畧反又直畧反	commentary
大閱	音恱	commentary
升朝	直遙反下朝各就同	commentary
扞難	乃旦反	commentary
辟害	音避	commentary
題別	彼列反下相別同	_
亡則	音無	commentary
解說	吐活反	commentary
弊之	婢世反劉薄計反	commentary
仆之	薄北反一音赴	commentary
甸亦	音田	commentary
獲旌	如字李一音胡霸反	commentary
都宗人之壝	唯癸反劉欲鬼反	_
祠	本亦作禱丁老反一音丁報反	commentary
報塞	西代反	commentary
家宗人居句	紀慮反下紀具反	_
繭栗	工典反	source
齊肅	側皆反	commentary
其知	音智	source
曰覡	胡歷反李胡隔反	commentary
令此	力呈反	commentary
物鬽	眉祕反	commentary
以禬	依注胡對反劉又戸外反	commentary
之札	側八反又音截	commentary
於墠	音善	commentary
螭鬽	勑知反	commentary