秋官司宼第五侀也	音刑	_
郷士	音香注同	source
訝士	五嫁反迎也	source
朝士	直遥反卷内同	commentary
司刺	七賜反殺也	source
三訊	音信	source
司約	劉於妙反一音如字注同	source
約束	劉詩樹反一音如字	source
約辭	於妙反	source
歃血	所洽反	_
賈四人	音嫁又音古	source
司圜	于權反	commentary
罷民	音皮下同	commentary
閩隷	亡巾反又音文	commentary
貉隷	孟百反	commentary
蜡氏	讀爲狙清預反注同	commentary
蠅蟲	以繩反	source
掩骼	更白反	commentary
貍	亡皆反本又作埋	commentary
骴	本又作胔似賜反	source
雍氏	於勇反劉如字注同	source
隄防	丁兮反	source
萍氏	音平又蒲丁反	commentary
爲蛢	蒲丁反爾雅云蛂蟥蛢郭注云甲蟲大如虎豆緑色	commentary
萍號	蒲丁反	commentary
萍蓱	上音平本亦作苹同下蒲丁反	commentary
者蘋	音頻	commentary
寤覺	音敎下同	commentary
司烜	音毁注燬同火也	commentary
爲垣	劉音袁	commentary
條狼氏	音滌徒歷反除也注同	source
冥氏	如字又莫歷反	_
縻取	亡皮反	commentary
庶氏	依注音藥煮之煮又章預反	commentary
毒蠱	音古	source
搏蟄	音博劉音付下直立反	commentary
翨氏	音翅失豉反又吉豉反鳥翮	source
柞氏	側百反注唶屋笮皆同	source
挍剥	古飽反	source
薙氏	字或作雉同他計反徐庭計反	commentary
去草	起吕反	commentary
芟夷	所銜反	commentary
蕰崇	紆粉反徐憂羣反	_
鬀小	他計反	source
硩	音摘他歷反徐丈列反沈勑徹反李又思亦反	commentary
蔟氏	倉獨反	source
蟲蠹	都路反	source
赤􁍶氏	赤如字一音采昔反􁍶徐音跋畔末反劉房末反	commentary
捇拔	上采昔反徐呼陌反下畔末反劉房末反或蒲八反	_
蟲豸	直氏反	commentary
蟈氏	古獲反注同劉音或又音國	commentary
爲蜮	劉音或一音古獲反	commentary
蝦	音遐	source
蟇	音麻	commentary
螻	音樓	source
鼃	户媧反又斛佳反	commentary
黽	莫幸反	source
食蛙	户蝸反劉斛佳反沈和佳反	commentary
蜮乃	音或	source
短狐與	音餘下官與同	commentary
壺涿氏	陟角反又音濁	_
相近	附近之近	commentary
主射	食亦反	commentary
絜清	才性反又如字	_
囂	五高元一音許驕反下同	_
讙	音歡	commentary
如箸	直慮反	commentary
爲繣	户卦反又胡麥反	_
伊耆	巨之反	commentary
爲蜡	仕詐反	source
國使	所吏反	commentary
環人	戸關反劉戸串反	commentary
才知	音智	source
狄鞮	丁兮反	commentary
曰譯	音亦	source
跛者	波可反	source
之好	呼報反	commentary
國治	直吏反	commentary
大司寇詰四	起吉反	_
旄荒	莫報反	commentary
度作	待洛反	commentary
爲民	于僞反	commentary
篡	初患反	_
殺	音試本亦作弑	source
糾守	劉音狩注同	commentary
將命	子匠反	source
上愿	音願劉又音原	commentary
糾暴	依注暴作恭	source
慤愼	苦角反	commentary
罷民	音皮注下皆同	source
不愍	音敏劉亡覲反尚書作暋音敏又作昬皆訓強	commentary
寘之	之豉反置也又音示	source
爲邪	似嗟反下同	commentary
著其	丁略反一音直略反	commentary
兩造	七報反至也注同	commentary
百个	古賀反	commentary
與	音餘	source
兩劑	子隨反	source
文石	如字劉音問	commentary
之	音樹	source
桎	音質	source
梏	古毒反	source
未著	直略反下附猶著皆同	commentary
肺石	芳廢反肺石赤石也	commentary
惸獨	其營反	commentary
其長	丁丈反下及注同	source
上書	時掌反	commentary
乃縣	音玄注及下同	source
挾日	子協反	source
盟約	於妙反	commentary
之藏	才浪反	source
司會	古外反下司㑹皆同	source
之治	直吏反下同	commentary
斷之	丁亂反下注皆同	source
弊之	必世反斷也後訓斷者皆同	source
爲憋	劉芳滅反又音卑設反	source
事比	必利反	source
納亨	普庚反劉普孟反注同下納亨放此	commentary
䟆	本亦作蹕音畢止行也	source
小司宼之難	乃旦反	_
冢適	丁歷反	source
芻蕘	而招反	source
南郷	許亮反	source
州長	丁丈反	source
不見	賢遍反	source
擯以	必刃反注同	commentary
敘更	音庚	commentary
訊之	音信	commentary
盡心	津忍反	source
讀鞫	九六反	_
爲治	于僞反	source
元咺	況阮反	source
鍼	其亷反	commentary
嚴子	劉音莊左傳作莊案漢書明帝名莊改爲嚴	source
則報	女板反	_
則喘	昌兖反	commentary
聽聆	音零	source
眸子	莫侯反劉無不反	_
眊然	莫報反本又作旄同	source
不偷	他侯反徐吐豆反	_
德行	下孟反	source
夫謀	音扶	commentary
而鮮	息淺反	source
叔向	許亮反	commentary
謂憔	昨遥反	commentary
悴	秦醉反	commentary
之後與	音餘	source
三刺	七賜反	commentary
斷庶	丁亂反後皆同	source
劓	魚器反	commentary
刖	音月又五刮反	commentary
大比	毗志反注同	commentary
以上	時掌反下注同	source
數民	所主反	commentary
鑊水	戸郭反	source
而辟	槪亦反劉符益反一音匹亦反沈音避注同後而辟皆放此	source
王道	音導	commentary
宣徧	音遍	commentary
入會	古外反後要㑹之字皆放此	commentary
士師之灋	音法	_
以左右	音佐下音又注左右助也同	commentary
徇之	似俊反	source
縣于	音玄	commentary
其觕	劉音粗沈才古反	commentary
曰誥	古報反	commentary
後射	食亦反	commentary
閭比	毗志反下同	commentary
比追	如字劉張類反	commentary
胥之	如字劉思敘反注偦同	commentary
司搏	音博劉音付	commentary
事比	必利反	commentary
邦汋	上灼反注同	commentary
斟汋	之林反下音灼	commentary
刺探	七亦反又七賜反	commentary
邦諜	音牒	commentary
反間	間厠之間	_
干冒	音墨	commentary
撟邦	音矯	commentary
寶藏	才浪反	commentary
作傰	劉音崩徐音朋又補鄧反	commentary
荒辯	依注辯音貶	source
風別之別繹於	音亦徐音夕	_
見於	賢遍反	commentary
内與	音餘下國服與同	_
呼趨	本又作趣同七須反劉音淸欲反	commentary
僔語	徐子損反劉才官反李一音纂	commentary
俘而	而孚	commentary
而搏	音博又音付	commentary
放失	音逸又如字	commentary
自卑	必二反	commentary
齓	初謹反又勑謹反劉測吝反沈創允反毁齒也	commentary
之治	直吏反下之治以治及司民職王治并注同	commentary
國期	居其反	_
乞鞫	九六反劉己目反	commentary
爲治	于僞反下爲治爲民同	source
爲別	彼列反下同	commentary
共賈	上如字下音古	commentary
畜積	勑六反下子賜反又如字	commentary
出者	尺遂反劉勑類反又如字	source
坐臧	才臥反	commentary
凡屬	如字或音燭注同	source
地傅	音付注同	source
町畔	徒頂反又他頂反	commentary
比屬	毗志反下及下文大比同	source
抵冒	丁禮反	source
上人	時掌反下文以上并注同	commentary
相辟	音避	commentary
爲窆	彼驗反	source
司民猶去	起吕反下同	_
更著	丁略反	source
三能	吐才反	commentary
近文昌	附近之近	commentary
司刑劓	魚器反李魚界反又疑婢反	_
刖	音月又五刮反李五骨反	commentary
黥也	其京反	source
窒之	本又作涅同乃結反徐丁吉反又丁結反	commentary
類與	音餘	source
斷足	丁管反	commentary
臏	頻忍反徐方忍反劉符人反	commentary
攘傷	如羊反	commentary
降畔	戸江反	source
撟虔	居兆反	commentary
司刺	七賜反下及注同	source
遺忘	音妄注同	source
不坐	才臥反下同	source
而軼	待結反	source
中人	丁仲反	source
若間	間厠之間	_
投射	食亦反	commentary
老	本又作旄同亡報反	commentary
憃愚	勑江反又貞巷反劉癡用反	commentary
癡騃	五駭反李又五亥反又吐在反	commentary
以上	時掌反	source
司約	於妙反後及注皆同	commentary
夔子	求龜反	source
之比	毗志反又必二反	commentary
者與	音餘	source
斐豹	音非徐方眉反劉方持反沈芳尾反	commentary
辟藏	才浪反注下皆同	source
爲之	于僞反	source
請隧	音遂	source
司盟子痤	才戈反	_
禮義	音儀	_
詛其	側慮反	source
與共	如字	source
惡之	烏路反	source
臧紇	恨發反劉胡没反沈胡謁反	source
使卒	子忽反	commentary
出豭	音加	source
行出	戸剛反	_
詛射	食亦反	commentary
以省	所景反	commentary
則爲	于僞反注同	commentary
職金楬而	音竭	_
璽之	音徙	commentary
守藏	劉音狩	source
以著	直畧反沈張慮反	commentary
揃其	音牋	source
表識	申志反又如字又音志	commentary
罰贖	常戍反下同一音蜀	commentary
金版	音板	commentary
鉼金	必領反	source
槍	七羊反	source
雷	劉音誄沈云當爲礌郎對反	source
椎㨃	直追反下宅耕反本又作桴劉云皆如字劉亦誤	source
司厲賈而	音嫁	_
舂槀	古老反	source
謂坐	才臥反下同	commentary
戮女	音汝	_
以上	時掌反	source
毁齒	況僞反下同	_
犬人用牷	音全本亦作全	_
伏瘞	於例反徐烏計反	source
轢之	音歷	commentary
用駹	亡江反	source
爲䃽	九委反劉居綺反	_
䃽縣	音玄	_
罷辜	劉孚逼反	commentary
凡相	息亮反注同	source
政治	直吏反	commentary
司圜著黒	丁畧反	_
幪	莫公反劉莫貢反	commentary
刑與	音餘	commentary
掌囚梏	古毒反張楫云參著曰梏偏著曰桎說文云梏手械也所以告天桎足械也所以質地	_
拲	劉云三家姜奉反一家居辱反漢書音義韋昭音拱云兩手共一木曰拲兩手各一木曰梏李竒音恐	commentary
而桎	之實反	commentary
以上	時掌反	source
爲王	于僞反	source
而著	丁畧反徐張慮反	commentary
掌戮賊諜	音牒	_
而搏	注作膊同普博反磔也	source
鈇鉞	音斧	commentary
今要	一遥反	source
反間	間厠之間	_
去衣	起吕反	source
踣諸	皮北反僵也	source
僵尸	居良反	_
禁御	音禦	_
遠之	于万反	_
守囿	音又	_
斷足	丁管反	commentary
髠	苦門反	commentary
守積	子賜反注同	commentary
司隷而搏	音博	_
爲百	于僞反注及下注同	commentary
涅廁	乃結反	commentary
厲遮	章奢反	source
例也	本又作列同音烈	commentary
罪隷使令	上如字劉色吏反下力呈反沈力政反	_
牽徬	歩浪反注同	source
助轉	如字劉張戀反	source
蠻隷校人	戸敎反	_
閩隷阜蕃	扶元反下注同	_
貉隷不生	如字劉色敬反	_
乳	而樹反	source
於圈	求阮反	source
檻	戸覽反	source
秋官司宼下布憲以詰	起吉反謹也	_
縣之	音玄下同	commentary
禁暴氏撟誣	居表反	_
好爲	呼報反下于僞反下則爲注皆爲同	commentary
謾誕	武諫反一音亡半反又免仙反徐望山反本或作慢誕音但	commentary
野廬氏巡行	下孟反	_
聚柝	音託	commentary
得令	力呈反下欲令同	commentary
轚互	音計沈古的反	commentary
迫隘	烏賣反	commentary
環轅	戸關反本亦作轘同	_
坻閣	徐之爾反劉都禮反	commentary
砥柱	音旨	commentary
射邪	食亦反下似嗟反	commentary
隄渠	丁兮反	commentary
兵杖	直亮反	commentary
則莫	音暮	commentary
操持	七曹反	commentary
反間	間厠之間	_
蜡氏	淸預反	commentary
骴	似賜反注㱴胔皆同㱴又作漬	commentary
作脊	子亦反李慈益反	commentary
掩骼	古百反	source
不蠲	古玄反舊音圭絜也	source
惟饎	昌志反	source
罷民	音皮	commentary
服衰	七雷反	source
皆爲	于僞反下爲其陷爲其就禽同	commentary
所薉	紆廢反今本多作穢	source
惡也	烏路反	commentary
置楬	音竭	commentary
縣其	音玄	commentary
雍氏澮池	古外反	_
爲阱	在性反塹也	source
擭	胡化反柞鄂也	commentary
謂陂	披冝反	commentary
障	之尚反	commentary
爲􁍴	七豔反本又作塹	source
柞	劉才伯反戚在洛反	commentary
鄂也	劉五格反戚五各反	source
粊誓	音祕	commentary
􁄽乃	音杜	source
敜乃	乃協反又乃結反	source
徐戎	劉本作䣄音徐	source
爲苑	紆阮反劉於願反	commentary
萍氏捕魚	音歩	_
苛察	音何又呼何反	commentary
沽買	音姑又音故下如字一本作賣	commentary
波洋	音翔又音羊	source
卒至	寸忽反	commentary
司寤氏行夜	下孟反下行夜同	_
徼候	古弔反	commentary
先明	悉薦反	source
星隕	于敏反	commentary
司烜氏夫遂	方符反或云司農音符	_
明齍	音資注作粢同	source
墳燭	符云反	source
庭燎	力召反	source
爲蕡	扶云反李一音婦輩反	commentary
中春	音仲	commentary
爲季	于僞反下爲葬皆爲同	source
風燥	素早反又素報反	commentary
明竁	昌銳反	commentary
刑剭	徐音屋劉音渥	commentary
葬與	音餘	commentary
條狼氏趨辟	七須反下婢亦反又音避劉薄易反徐扶亦反注趨辟辟行人同	_
今卒	子忽反下羡卒同	commentary
辟車	必亦反又婢亦反	source
車轘	戸串反一音環	commentary
大史	音㤗注同	source
行前	戸剛反	commentary
以警	京領反	source
復請	劉上音服下音情	commentary
脩閭氏掌比	毗志反下同	source
宿互	如字劉息就反	commentary
國粥	音育	commentary
其追	知字劉張類反	commentary
爲偦	音胥又息吕反	source
冥氏	音覓	_
罿	昌容反劉上凶反	commentary
罦	音浮	source
以扄	古熒反	_
絹	古犬反一音古縣反翨氏注同	commentary
敺之	丘于反後同	_
搔也	音爪	source
庶氏	章預反	commentary
毒蠱	音古	source
說禬	劉音潰戸内反	commentary
嘉艸	音草本亦作草	_
敎令	力呈反	commentary
求去	起吕反	source
燻之	許云反	commentary
翨氏而掎	居綺反注同	_
鷹隼	息允反	source
羽翮	戸革反	commentary
柞氏	側百反	source
林麓	音鹿	commentary
刊陽	芒于反	commentary
斫去	起吕反	source
其肄	以四反	commentary
薙氏秋繩	音孕以證反含實也注同	_
而芟	所銜反	commentary
甍	音萌	source
玆其	音基兹其鉏也	source
鉤鐮	音亷	_
取茭	音交	commentary
剗之	初産反劉側展反	source
硩蔟氏掌覆	芳復反毁也注同	commentary
夭鳥	音妖後夭鳥同	source
若鴞	于驕反	commentary
􁍵	音服	source
縣其	音玄	source
從娵	徐劉沈並子須反	source
至荼	劉沈音餘李音舒又音徒案爾雅正月爲陬即離騷所云攝提貞于孟陬皆側留反又子侯反爾雅又云十二月爲涂音徒今注作娵荼二字是假借耳當依爾雅讀	source
從攝提格至赤奮苦	爾雅曰太歳在寅曰攝提格在丑曰赤奮若	_
翦氏蠹物	丁故反	_
以攻	如字劉音貢	commentary
禜	音詠	commentary
莽草	亡蕩反又莽草藥名	commentary
爲櫜	劉古毛反本或作橐他各反	commentary
凡庶	章預反	commentary
赤􁍶氏以蜃	市軫反	_
灰洒	色買反劉霜寄反	commentary
蟲豸	直氏反	source
以坋	蒲悶反	commentary
淳之	之純反	commentary
貍蟲	莫皆反劉莫拜反	commentary
䗪	章夜反	commentary
肌	居其反	commentary
求	本或作蛷音求劉音俱	commentary
蟈氏掌去	起吕反注去之同	commentary
鼃	户媧反	commentary
黽	莫幸反	source
牡蘜	莫口反下弓六反	source
爲聒	于僞反下古活反銜枚氏放此	commentary
煙被	皮義反注同	commentary
假令	力呈反注同	commentary
壺涿氏炮土	歩交反注泡苞同	_
狐蜮	音或	source
燔之	音煩	commentary
牡橭	劉音沽杜讀爲枯云枯榆木名也劉亦音枯案如杜義則音姑山榆也	_
爲梓	音子本或作橭	commentary
爲樗	勑居反	source
庭氏掌射	食亦反下注同	commentary
鳴呼	喚故反下文􁅭呼同	commentary
大隂	音泰下文同	commentary
陽與	音餘	source
譆譆	許其反	commentary
詘詘	劉音出本亦作出	_
銜枚氏司囂	五羔反下同	_
讙者	呼九反	commentary
在朝	直遥反下同	commentary
禁􁅭	音呌	_
鳴吟	魚今反	_
伊耆氏爲函	音咸	_
去之	起吕反	commentary
別史	彼列反	_
卒	子忽反	source
杖鉞	直亮反又音丈下音越	commentary
大行人要服	於遥反下文及注同	_
春朝	直遥反後皆同	source
以比	毗志反注同	commentary
春見	徐賢遍反戚如字夏秋冬放此	commentary
更	音庚	commentary
迭	直結反	commentary
而徧	音遍下文注皆同	commentary
時見	賢遍反下殷見同	commentary
九伐	如字劉扶發反	source
之好	呼報反注同	source
殷覜	通弔反	commentary
之慝	吐得反	commentary
使來	色吏反	commentary
惡行	下孟反	commentary
閒問	閒厠之閒注同	commentary
歸脤	上忍反	source
致禬	音㑹	source
澶淵	市然反	commentary
繅	音藻	commentary
藉	在夜反下及注同	commentary
九斿	音留下同	commentary
樊纓	畔干反下同	commentary
九乗	繩證反下同	_
介九	音界下及注同	commentary
車軹	之氏反或居氏反	commentary
擯者	必忍反後皆同	commentary
再祼	古亂反	commentary
而酢	才洛反	commentary
食禮	音嗣下及注皆同	commentary
五積	子賜反後皆同	source
三勞	老報反下及注并小行人司儀職放此	commentary
信圭	音申後信圭同	source
衣版	於旣反	commentary
著冕	丁畧反	source
屬其	章玉反	commentary
幓	音衫	commentary
以罽	居例反	commentary
齊僕	側皆反	commentary
當軫與	音餘下是與歩與皆同	source
以飲	於鴆反下同	commentary
不恙	羊尚反	source
餽之	本又作饋求位反徐紀畏反	_
柱地	張矩反	commentary
九飯	扶晚反	source
降殺	色界反	commentary
無相	息亮反注同李息丈反	commentary
其摯	本又作贄音至	_
見	賢遍反下文壹見而見之朝見皆同	commentary
傳辭	直專反	commentary
齊酒	才計反	commentary
各下	戸嫁反注同	commentary
嬪物	婢人反	commentary
絺	勑之反劉豬履反	source
纊	音曠徐劉古曠反	commentary
見傳	上賢遍反下直戀反一音上如字下直專反	commentary
屬象	徐劉皆章束反下及注同	source
作叶	音協	source
詞	音辭	source
譯官	音亦	source
爲汁	之十反叶也又音協	commentary
爲諝	思敘反	source
者慾	市志反下音欲本多作欲	_
狄鞮	丁兮反	commentary
重譯	直龍反	source
才知	音智	source
以上	時掌反	commentary
齎其	子兮反	commentary
賔而	劉云應言擯小行人職同	source
詔相	息亮反注同	source
小行人之使	色吏反注同後使者使適使之四方竹使使臣皆同	_
眂館	音視	_
所爲	于僞反	source
瑱圭	劉吐電反案王執鎭圭瑱冝作鎭音	commentary
琮	才宗反	source
琥	音虎	commentary
璜	音黃	source
之好	呼報反	source
槁禬	苦報反下音㑹	commentary
作槀	古老反	_
敎治	直吏反	commentary
康樂	音洛	commentary
司儀擯相	息亮反此職内經注除相爲賔相朝相授相親相隨相待相爲國客相聘相禮皆同	_
壝土	唯癸反劉欲鬼反	source
此與	音餘下尺與同	source
三重	直龍反下三重重耳同	source
敦丘	音頓沈又都門反	commentary
陶丘	徒刀反	commentary
昆侖	力門反	commentary
三復	音服或芳服反	commentary
之玷	丁簟反沈都念反	commentary
宫縚	吐刀反	_
之行	下孟反	commentary
見王	賢遍反	_
諸侯毛	毛謂須髮也劉本作音毛	commentary
皆旅	如字又音臚力於反	commentary
傳辭	直專反下除春秋傳皆同	source
末上	時掌反下上傳上車同	source
致飧	素尊反下同	_
授幣	依注授音受	commentary
賔拜送	依注賔音擯下賔使者同	source
告辟	音避劉薄歷反注同下客辟三辟趨辟放此	commentary
巳辟	音避	source
詔侑	音又	commentary
拂闑	魚列反	source
中棖	直庚反	commentary
鴈行	戸剛反	source
還圭	音環又音旋	commentary
饗食	音嗣凡饗食皆同	commentary
費也	芳味反	commentary
降殺	色界反下豐殺則殺及後殺禮皆同	source
逡巡	七旬反	commentary
客甚勞	如字下甚勞勞辱同	source
客	本又作從同才用反	source
乗禽	繩證反下乗皮同	_
上下	時掌反	source
各稱	尺證反	commentary
束紡	芳往反	source
不朝	如字又直遥反	source
不背	音佩	source
東郷	許亮反下同	source
行夫傳	張戀反注同	_
遽	其庶反	commentary
其使	色吏反注及下同	commentary
有難	乃旦反注同	commentary
傳命	直宣反象胥職同	commentary
焉使	劉焉音夷	commentary
環人殉環	徐音循或辭俊反	_
及疆	居良反	source
苛留	音何又呼何反	source
象胥閩	亡巾反又音文	_
貉	亡百反	commentary
國使	所吏反	commentary
壹見	賢遍反	_
而賔	音擯下同	commentary
相之	息亮反下同	commentary
掌客政治	直吏反注同	_
侯長	丁丈反注同	source
敵用	丁歷反	commentary
從者	才用反下注從賔同	commentary
繭栗	古典反	commentary
鉶	音刑	source
牲三十有六	依注牲音星下牲十有八受牲禮同	commentary
二十筥	姜吕反	commentary
二十罋	烏弄反	commentary
五籔	素口反劉色縷反	commentary
三秅	丁故反或丈加反	commentary
乗禽	繩證反下及注同	_
三食	音嗣下食大牢再食壹食注不食同	source
皆見	賢遍反注下除相見見讀皆同	source
皆飪	而甚反	_
西夾	古洽反劉古協反下同	commentary
非衰	初危反下同	commentary
差也	初佳反又初冝反	commentary
倍鼎	音裴	_
二行	戸剛反下六行四行二行皆同	commentary
從陳	子容反	source
稾實	古老反	commentary
并刈	必政反又必盈反	source
曰緫	本又作緵子工反李又音揔	_
手杷	必馬反	_
棟梠	音吕	commentary
一穧	才計反	source
參差	初林反下初冝反	commentary
不復	扶又反	commentary
勞賔	老報反	commentary
造館	七報反	commentary
秅秭	徐音姊劉祖禮反	commentary
皆爲	于僞反下同	source
愛費	芳味反	commentary
芻稍	所敎反舊踈詔反	commentary
煎	子然反劉子賤反	commentary
亨	普庚反劉普孟反	commentary
掌訝野廬	力於反	_
求索	色白反	commentary
道之	音導下文注道之道賔道王同	commentary
退復入迎	復扶又反	commentary
爲之	于僞反亦如字	source
之治	直吏反注下同	source
訝爲	于僞反下則爲同	source
凡從	才用反注同	source
於竟	音境	source
詔相	息亮反	source
掌交之好	呼報反注下皆同	_
惡	烏路反注同	source
辟行	音避注同	source
之說	音恱注同	source
之難	乃旦反	source
朝大夫國治	直吏反注下同	_
君長	丁丈反注同	commentary
殿之	都練反	commentary