臯陶謨第四爲帝	于僞反	_
夫	音扶	commentary
治	直吏反下同	source
蹈	徒報反	source
身修	絶句	commentary
惇	切韻都昆反	_
當	丁浪反下同	commentary
亦行	下孟反注性行行正直之行同	commentary
愿	音願	commentary
愨	切韻苦角反	_
恪	苦各反	commentary
擾	而小反徐音饒	source
毅	五旣反	commentary
斷	丁亂反	commentary
撓	女孝反	commentary
浚	息俊反馬云大也	commentary
嚴	如字馬徐魚簡反	commentary
翕	許及反	source
俊乂	馬曰千人曰俊百人曰乂	source
百僚	本又作寮	source
撫	方武反	source
凝	魚凌反馬云定也	source
兢兢	居凌反	source
業業	如字徐五荅反	source
幾	徐音機	commentary
有典	馬本作五典	commentary
有分	符問反	commentary
有庸	馬本作五庸	source
衷	音中	commentary
明畏	畏如字徐音威馬本作威	commentary
有知	如字徐音智	commentary
思	如字徐音息吏反	commentary
襄	息羊反上也馬云因也案爾雅作儴因也如羊反	commentary