禹貢第一卷之三夏書	凡九篇五篇亡一云夏書唯四篇	_
別	彼列反	source
九州	周公職録云黃帝受命風后受圗割地布九州鄹子云中國爲赤縣赤縣之内有九州春秋說題辭云州之言殊也	source
圻	其依反	commentary
濬	思俊反	commentary
刊	苦安反	_
任	而鴆反	commentary
貢	字或作贛	commentary
之王	于況反	commentary
敷	芳無反馬云分也	commentary
汎	孚劒反	source
隨行	下孟反	commentary
奠	田遍反	commentary
瀆	音獨下同	commentary
冀	居器反	commentary
州	九州名義見爾雅音	commentary
載	如字載載於書也馬同鄭韋昭云載事也	source
壺	音胡馬云壺口山名	_
治	如字	commentary
岐	其冝反	commentary
雍	於用反後州名同	commentary
岳	字又作嶽太岳山名	commentary
陽	山南曰陽水北亦曰陽	commentary
覃	徒南反	commentary
厎	之履反	_
衡	如字橫也馬云水名	commentary
漳	音章	commentary
近河	附近之近	commentary
壤	汝丈反馬云天性和美也	commentary
塊	苦對反	commentary
上	如字賦第一	commentary
錯	倉各反馬云地有上下相錯通率第一	commentary
以供	音恭	commentary
中	丁仲反又如字	commentary
中	馬云土地有髙下	commentary
肥	符非反	commentary
瘠	在亦反	commentary
旣從	才容反	commentary
㠀	當老反馬云㠀夷北夷國	commentary
夾	音協注同帶也	commentary
碣	其列反韋昭其逝反	commentary
逆上	時掌反	commentary
篚	方尾反	commentary
濟	子禮反下同	commentary
兖	恱轉反	commentary
九河	徒駭一太史二馬頰三覆釜四胡蘇五簡六絜七鈎盤八鬲津九岀爾雅	commentary
灉	徐音邕王於用反	commentary
沮	七餘反	commentary
蠶	在南反	commentary
墳	扶粉反後同韋昭音勃憤反起也馬云有膏肥也	commentary
繇	音遥馬云抽也	source
十有三載	馬鄭本載作年	source
漆	音七	commentary
盛	音成	commentary
漯	天荅反篇韻作他合反	commentary
岱	音代泰山也	commentary
嵎	音隅	commentary
濰	音惟本亦作惟又作維	commentary
淄	側其反	commentary
濵	必人反	commentary
斥	徐音尺說文云東方謂之斥西方謂之鹵鄭云斥謂地鹹鹵	commentary
涯	魚佳反	commentary
鹽	餘占反	commentary
絺	勑其反	commentary
種	章勇反	source
畎	工犬反徐本作畎谷	commentary
枲	思似反	commentary
鈆	寅專反字從㕣㕣音以選反	commentary
怪	如字	commentary
石	怪石碔砆之屬	commentary
萊	音來	commentary
牧	牧養之牧徐音目一音茂注同	commentary
檿	烏簟反山桑也	commentary
汶	音問	source
沂	魚依反水名	source
藝	魚世反	commentary
豬	張魚反馬云水所停止深者曰豬劉東胡反	commentary
埴	市力反鄭作戠徐鄭王皆讀曰熾韋昭音試	commentary
漸	如字本又作蔪字林才冉反草之相包裹也	source
包	必茅反字或作苞非叢生也馬云相包裹也	commentary
黏	女占反	source
進長	丁丈反	commentary
叢	才公反	commentary
燾	徒報反覆也	commentary
苴	子餘反包裹也	commentary
夏	行雅反	commentary
翟	徒歷反	commentary
嶧	音亦一音夕	commentary
泗	音四水名	commentary
淮夷	鄭云淮水之夷民也馬云淮夷二水名孔傳云淮夷之水本亦有作淮夷二水也	source
蠙	蒲邊反徐扶堅反字又作比韋昭薄迷反蚌也	commentary
曁	其器反	source
見石	上賢遍反	commentary
纎	息亷反	commentary
縞	古老反徐古到反	commentary
繒	似陵反	commentary
達于河	如字說文作菏工可反云水出山陽湖陵南	_
彭蠡	下音禮張勃吳録云今名洞庭湖案今在九江郡界	commentary
三江	韋昭云謂吳松江錢唐江浦陽江也吳地記云松江東北行七十里得三江口東北入海爲婁江東南入海爲東江并松江爲三江	commentary
震澤	吳都太湖	commentary
底	之履反致也史記音致	commentary
大湖	音太胡	commentary
篠	西了反	commentary
簜	徒黨反或作他莽反	commentary
夭	於嬌反馬云長也	commentary
喬	其驕反徐音驕	commentary
少	詩照反	commentary
長	丁丈反	commentary
瑶	音遥	commentary
琨	音昆美石也馬本作瑻韋昭音貫	commentary
犀	細兮反	commentary
旄	音毛	commentary
楩	音緶又婢善反	commentary
卉	徐許貴反	commentary
橘	均必反	commentary
柚	由究反	commentary
裹	音果	commentary
㳂	恱專反鄭本作松松當爲㳂馬本作均云均平	source
朝	直遥反	source
九江	㝷陽地記云一曰烏白江二曰蚌江三曰烏江四曰嘉靡江五曰畎江六曰源江七曰廩江八曰提江九曰箘江張須无縁江圗云一曰三里江二曰五州江三曰嘉靡江四曰烏土江五曰白蚌江六曰白烏江七曰箘江八曰沙提江九曰廩江參差隨水長短或百里或五十里始于鄂陵終于江口㑹于桑落洲太康地記曰九江劉歆以爲湖漢九水入彭蠡澤也	commentary
沱	徒何反	source
潛	捷廉反馬云沱湖也其中泉出而不流者謂之潛	_
雲	徐本作云	commentary
夢	亡弄反一音武仲反徐莫公反	source
治	直吏反	commentary
杶	勑倫反徐勑荀反木名又作櫄	source
榦	本又作幹故旦反	commentary
栝	古活反馬云白栝也	source
柘	章夜反	commentary
礪	力世反	commentary
砥	音脂徐之履反韋昭音旨	commentary
砮	音奴韋昭乃固反	commentary
磨	末佐反	commentary
鏃	子木反一音七木反	commentary
箘	求隕反韋昭一名聆風	commentary
簵	音路	commentary
楛	音户馬云木名可以爲箭毛詩草木䟽云葉如荆而赤莖似蓍	commentary
近澤	附近之近	commentary
匭	音軌	commentary
菁茅	上子丁反徐音精馬同鄭云茅有毛刺曰菁茅	commentary
匣	胡甲反又音甲	commentary
菹	切韻側魚反	commentary
縮	所六反	commentary
纁	許云反	source
璣	其依反又音機馬同說文云珠不圜也字書云小珠也玉篇渠依居沂二反	commentary
組	音祖馬云組文也	source
納	馬云入也	commentary
江沱潛漢	四水名本或作潛于漢非	_
逾	羊朱反	commentary
瀍	直然反	commentary
澗	故晏反	commentary
渾	音魂又胡囷胡昆二反	commentary
沔	亡淺反又亡忍反下同陸渾沔池二縣屬河南郡	commentary
滎	戸扃反滎澤也	commentary
波	如字馬本作播滎播澤名	commentary
遏	烏葛反	commentary
導	音道下同	commentary
菏	徐音柯又士可反注同韋胡阿反	commentary
被	皮寄反徐扶義反注同	_
孟豬	張魚反又音諸左傳爾雅皆作孟諸宋藪澤也	commentary
壚	音盧說文黒剛土也	source
絺	勑其反	commentary
紵	直吕反	commentary
纊	音曠	commentary
緜	切韻武延反	_
華	胡化反又胡瓜反	source
岷	武巾反	commentary
嶓	音波徐甫河反韋音播	commentary
旅	如字韋音盧	commentary
和	如字又作龢鄭云和讀曰洹	commentary
言治	直吏反下同	commentary
黎	鄭力兮反徐力私反馬云小䟽也	commentary
璆	音蚪徐又居蚪反又閭幼反馬同韋昭郭璞云紫磨金案郭注爾雅璆即紫磨金	commentary
鐵	天結反	commentary
鏤	婁豆反	commentary
熊	音雄	commentary
羆	彼冝反如熊而黃	commentary
貍	力疑反	commentary
罽	紀例反	source
傾	窺并反	commentary
渭	音謂	commentary
雍	於用反	commentary
涇	音經	commentary
屬	之蜀反	commentary
汭	本又作内同如銳反馬云入也	commentary
逮	音代	commentary
沮	七徐反	commentary
灃	芳弓反	commentary
治	直吏反	commentary
終南	終南山名漢書地理志一名太一三秦記云又名地肺	commentary
惇	惇物山名漢書云垂山也	_
丕	普悲反	source
球	音求	commentary
琳	韋音來金反	source
琅	音郎	commentary
玕	音干山海經云崐崘山有琅玕樹	source
西上	時掌反	commentary
崐崘	下魯門反馬云崐崘在臨羌西	commentary
析	星歷反馬云析支在河關西	source
搜	所由反漢書志朔方郡有渠搜縣武紀云北發渠搜是也	commentary
髳	音謀又音毛西戎國名	commentary
導	音道從首起也	commentary
岍	音牽字又作汧山名一名吳岳馬本作開	commentary
厎	之履反	_
柱	如字韋知父反又知女反厎柱山名在河水中	commentary
太行	戸剛反又如字	_
滄	音倉	source
勝	音升	_
傾	窺并反	_
圉	魚吕反	_
太華	如字又戸化反	_
陪	音裴	_
尾	陪尾山名漢書作橫尾	_
條列	如字本或作別彼列反	_
漾	羊尚反	commentary
弱	本或作溺	commentary
合	如字	commentary
黎	力兮反馬云地名	commentary
溢	音逸	commentary
山見	賢遍反	commentary
虢	寡白反	commentary
孟津	如字洛北地名	commentary
湊	七豆反	commentary
伾	本又作岯音丕又皮鄙反徐扶眉反又敷眉反韋音嚭郭撫梅反字或作	commentary
處	昌慮反	commentary
降	如字鄭戸江反	commentary
殺	所界反	source
溢	字又作隘於賣反	source
渤	蒲兀反	commentary
浪	音郎	commentary
澨	市制反	commentary
觸	切韻尺玉反	commentary
匯	徐胡罪反韋空爲反	commentary
沱	唐何反	commentary
澧	音禮	source
迆	以爾反馬云靡也	commentary
沇	音兖又以轉反	source
數	色主反下同一本作十所	commentary
陶	音桃	commentary
折	之設反	commentary
灃	音豐	commentary
翊	與職反	commentary
鞏	恭勇反縣名屬河南郡	commentary
隩	於六反玉篇於報反	source
滌	待歷反	source
陂	彼冝反	source
槎	仕雅反	commentary
障	章尚反	commentary
貫	工喚反	source
較	音角	commentary
台	徐音怡	commentary
行	下孟反注同	source
甸	田遍反	commentary
爲天	上于僞反	commentary
納	如字本又作内音同下如字	commentary
緫	音揔	source
近	附近之近	source
稾	故老反	_
供	音恭	commentary
飼	音嗣	source
銍	珍栗反	source
穗	字亦作穟音遂	commentary
秸	本或作稭工八反馬云去其穎音鞂	source
男任	而針反又而鴆反	commentary
任王	上而鴆反又而針反	source
同爲	于僞反	source
綏	息遺反	commentary
揆	葵癸反	commentary
度	待洛反	commentary
奮	方問反	commentary
要	一遥反	commentary
束	如字一音來	commentary
夷	馬云易也	source
差	初隹反又初賣反	commentary
漸	子亷反	commentary
被	皮寄反	_
朔南	朔北也	commentary
皆與	音預	commentary
朝	直遥反	commentary
見	賢遍反	commentary
訖	斤密反	commentary