泰誓上第一卷之六周書	凡四十一篇九篇亡	_
虞芮	如銳反二國名	commentary
僉	七廉反	commentary
孟津	地名也	source
惟十有三年春	或作十有一年後人妄看序文輒改之	commentary
亶	丁但反	commentary
湎	面善反	source
冒	莫報反注下同	commentary
嗜	市志反切韻常利反	source
酷	苦毒反	commentary
榭	爾雅云有木曰榭本又作謝	source
陂	彼皮反	commentary
障	之亮反	commentary
匱	其魏反	source
刳	口胡反	source
剔	他歷反	source
孕	以證反徐養證反	source
悛	七全反	commentary
粢	音咨黍稷曰粢	source
盛	音成在器曰盛	commentary
懲	直承反	commentary
不爭	爭鬪之爭	commentary
爲立	上于僞反	commentary
相	息亮反	source
否	方有反	source
度	徒洛反下注同	commentary
億	十萬曰億	commentary
貫	古亂反	commentary
類	師祭名	commentary
冢	中勇反	_
厎	之履反	source
從之	上才容反	commentary