牧誓第四戎車	音居釋名云古者聲如居所以居人也今曰車聲近舎車舎也韋昭辯釋名云古皆尺遮反從漢始有音居	_
夫長	丁丈反	commentary
步卒	子忽反	_
賁	音奔	commentary
士稱	尺證反	commentary
牧	如字徐一音茂說文作坶云地名在朝歌南七十里字林音母	commentary
昧爽	上音妹爽明也昧爽謂早旦也馬云昧未旦也	commentary
夜陳	直刃反	commentary
左杖	徐直亮反	source
鉞	音越本又作戉	commentary
旄	音毛馬云白旄旄牛尾	commentary
麾	許危反	commentary
逖	他厯反	commentary
帥	色類反下同	commentary
羌	徐起良反說文云西戎牧羊人	commentary
髳	茂侯反	commentary
濮	音卜	commentary
叟	所求反又蘇走反	commentary
比	徐扶志毗志二反	commentary
楯	食準反又音允	commentary
牝	頻引反徐又扶忍反	commentary
索	西各反	source
妲己	丹達反下音紀紂妻也	commentary
復	扶又反	commentary
俾	必爾反使也徐甫婢反下同	commentary
宄	音軌	commentary
愆	去乾反	commentary
朂	許玉反	_
刺	七亦反	_
貔	音毗	_
羆	彼皮反爾雅云羆如熊黃白文	_
迓	五嫁反馬作禦禁也	_
役	馬云役為也為音于偽反	_