康誥第十一數叛	上所角反叛亦作畔	_
梓	音子	source
圻	具依反	source
魄	字又作魄普白反馬云魄朏也謂月三日始生兆朏名曰魄	commentary
汭	如銳反	commentary
和見	賢遍反	commentary
乃洪大誥治	直吏反注及下其治民安治用安治同一本作周公迺洪大誥治	commentary
皆勞	力報反	commentary
孟長	丁丈反下同	commentary
愼去	羌吕反下欲去去疾同	commentary
怙	音戸	commentary
冒	莫報反覆也	commentary
聞	如字徐又音問	commentary
殪	於計反	commentary
勗	許玉反	commentary
遹	音聿又音述馬云述也	source
衣	如字徐於旣反	commentary
耇	音狗	commentary
恫	音通又勑動反	commentary
􁒓	古頑反	_
棐	音匪又芳鬼反	source
忱	市林反	commentary
往盡	徐子忍反	commentary
好	呼報反	commentary
懋	音茂	source
應	應對之應注同徐於甑反	commentary
眚	所領反本亦作省	commentary
宥	于救反	commentary
咎	其九反	commentary
孩	亥才反	commentary
劓	魚器反	source
刵	如志反	commentary
臬	魚列反	source
要	於宵反	commentary
蔽	必世反	commentary
斷	丁亂反下及篇末同	commentary
覆	芳服反	commentary
彞	以支反下同	source
𣢾	苦管反	_
攘	如羊反	commentary
宄	音軌	source
暋	音敏	source
憝	徒對反徐徒猥反	commentary
強	其丈反	source
無不惡	烏路反下所大惡疾惡亦惡並音同	commentary
鞠	居六反	commentary
弔	音的	commentary
泯	徐武軫反	commentary
戛	簡八反	_
乃别	彼列反注同	commentary
汝長	丁丈反下同	commentary
忌	其記反	commentary
懌	音亦	source
爲求	上于僞反	commentary
之說	如字徐始銳反	commentary
假令	力呈反	commentary
數	所角反	commentary
殛	紀力反	commentary