君奭第十八卷之十爲保	太保也
爲師	太師也馬云保氏師氏皆大夫官
相	息亮反
左右	馬云分陜爲二伯東爲左西爲右
不說	音恱
奭	始亦反召公名
弔	音的
棐	音匪又芳鬼反
忱	市林反
其終	終馬本作崇云充也
君巳	音以
遏	於葛反徐音謁絶反
佚	音逸
不易	以豉反注同
諶	氏壬反
我道	馬本作我迪
去之	上如字又起吕反
尹摰	音至
隕	于敏反
傅說	音恱
安治	直吏反下同
屏	賔領反
辟	必亦反
重斷	丁亂反
踐	似淺反馬同大傳云藉也
數	色角反
覆	芳服反
成王政	如字馬本作征云正
蒲	如字徐又扶各反馬本作薄
近中	附近之近
