駉第二十九	本或作駉之什者是隨例而加耳商頌亦然	_
魯頌	魯者周公之子伯禽所封之國也周公有大勲勞於天下成王留之輔相而封伯禽焉其封域在禹貢徐州蒙羽之野十七世至僖公當周惠王襄王之時能遵伯禽之法外征淮夷内脩德敎國人美之於是國卿季文子請周而使史克作頌四篇夫子刪詩録之者以周公有致太平之勲成王命魯郊祭用天子禮樂故取魯頌而同於王者之後焉	source
駉	古熒反說文作驍又作駫同	commentary
牧乎	徐音目	_
坰野	古熒反徐又苦營反或苦瓊反逺也林外曰坰下同	commentary
行父	音甫注同行父季文子名也	commentary
牡馬	茂后反草木䟽云騭馬也說文同本或作牧	commentary
有驈	戸橘反阮孝緒于密反顧野王餘橘反郭音述驪馬白跨曰驈	commentary
有驪	力知反沈又郎西反純黒馬也說文字林云深黒色馬也	commentary
白跨	苦化反又苦故反又胡瓦反郭云髀閒也蒼頡篇云兩股閒也	commentary
黃騂	息營反赤黃曰騂下文同字林火營反	commentary
四種	章勇反	source
有駑	音奴	commentary
飲食	上音䕃下音嗣又並如字	commentary
無疆	居良反竟也	commentary
反覆	芳服反	commentary
有騅	音隹蒼白雜毛曰騅	commentary
有駓	符悲反字又作䮆黃白雜毛曰䮆郭云今桃花馬也字林作駓音丕	commentary
有騏	音其蒼祺曰騏	commentary
伾伾	敷悲反有力也說文同字林作駓走也父之反音丕	commentary
蒼祺	音其字又作騏	_
驒	徒河反靑驪驎曰驒說文云馬文如鼉魚也韓詩及字林云白馬黒髦也	commentary
駱	音洛白馬黒鬣曰駱樊孫爾雅並作白馬黒髦鬛尾也	commentary
駵	音留赤身黒鬣曰駵字林云赤馬黒髦尾也	commentary
雒	音洛黒身白鬛曰雒本或作駱同	commentary
繹繹	音亦善足也一本作善走也崔本作驛	commentary
驎	本亦作甐郭良忍反毛色有深淺斑駮隱甐今之連錢􁇰也吕忱良振反孫炎音鄰云似魚鱗也	commentary
黒鬣	力輒反	_
無斁	音亦厭也	commentary
駰	舊於巾反讀者並音因隂白雜毛曰駰	_
騢	音遐彤白雜毛曰騢說文云赤白雜色文似鰕魚	_
驔	音簟徒點反字林云又音譚豪骭曰驔	_
有魚	如字字書作字林作䁩音並同毛云一目白曰魚爾雅云一目白瞷二目白䁩瞯音閑	_
祛祛	起居反彊健也	_
彤白	徒冬反赤也	_
豪骭	戸晏反	_
無邪	似嗟反注同	_
無復	扶又反	source
有駜	備筆反又符必反馬肥彊貌字林又父必反	commentary
乗黃	繩證反下同	commentary
大學	音泰	_
咽咽	本又作鼝同烏玄反又於巾反鼓節也	commentary
樂兮	音洛注喜樂下于胥樂兮及注安樂同	commentary
之朝	直遥反	commentary
駽	呼縣反又火玄反徐又胡眄反青驪曰駽又音炫	commentary
歳其有	本或作歳其有矣又作歳其有年者矣皆衍字也	commentary
詒孫子	以之反遺也本或作詒厥孫子詒于孫子皆是妄加也	commentary
詒遺	唯季反下同	commentary
泮水	普半反	source
頌僖	音希	commentary
頖宫	音判本多作泮泮宫諸侯之學也泮半也半有水半無水也鄭注禮記云頖班也所以班政敎	_
其芹	其巾反水菜也	commentary
天子辟	音璧下同	commentary
圜如	音貟	_
來觀	古亂反又音官	commentary
伐伐	蒲害反又普貝反言有法度本又作茷	_
噦噦	呼會反有聲也	commentary
其藻	音早水草也	commentary
蹻蹻	居表反彊盛也	commentary
昭昭	之繞反	commentary
其茆	音卯徐音桞韋昭萌藻反鳧葵也干寳云今之􁇱蹗草堪爲菹江東有之何承天云此菜出東海堪爲菹醬也鄭小同云江南人名之蓴菜生陂澤中草木䟽同又云或名水葵一云今之浮菜即猪蓴也本草有鳧葵陶弘景以入有名無用品解者不同未詳其正沈以小同及草木䟽所說爲得	commentary
鳧葵	音符	commentary
者與	音餘	_
屈此	丘勿反毛云收也鄭云治也徐云鄭又其勿反韓詩云屈收也收斂得此衆聚	commentary
昭假	古百反至也	commentary
之行	下孟反又如字	commentary
伊祜	音戸福也	source
蟜蟜	本又作矯亦作蹻居表反武貌	_
獻馘	古獲反截耳也	commentary
皐陶	音遥皐陶唐虞之士官	source
狄彼	王他歷反達也孫毓同鄭作剔音同治也沈云毛如字未詳所出韓詩云鬄鬄除也	commentary
烝烝	之承反	commentary
皇皇	毛如字美也鄭作暀暀于況反猶往往也	commentary
不吳	鄭如字讙也又王音誤作吳音話同	commentary
瘍	余章反	_
于訩	音凶訟也	commentary
讙也	音歡	_
讙譁	音花	source
無爭	爭鬪之爭	_
其觓	音虯毛云弛貌鄭云持弦急也	_
其捜	依字作摉色留反毛衆意鄭勁疾也	_
孔博	徐云毛如字王同大也鄭作傅音附	source
無繹	本又作射又作斁或作懌皆音亦厭也	source
施貌	式氏反本又作弛同	_
致者	直置反	commentary
士卒	尊忽反	commentary
堙井	音因塞也	commentary
刊木	苦干反服䖍云削也	_
度己	待洛反	commentary
翩彼	音篇飛貌	commentary
飛鴞	于嬌反惡聲鳥也	commentary
桑黮	說文字林皆作葚時審反桑實也	commentary
爲此	于僞反	source
憬彼	九永反逺行貌沈又孔永反說文作懬音獷云闊也一曰廣大也	commentary
其琛	勑金反犍爲舎人云美寳曰琛	source
大賂	音路遺也	commentary
遺也	唯季反	source
閟宫	筆位反毛閟閉也鄭閟神也音秘同	commentary
僖公	音希	commentary
有侐	況域反淸靜也說文云靜也一音火季反	commentary
枚枚	莫回反礱密也韓詩云閒暇無人之貌也	commentary
姜嫄	音元	commentary
是禖	莫回反	commentary
礱密	路東反厲也	commentary
無災	字又作灾本亦作葘音同	commentary
回邪	似嗟反	_
天用是馮依	本又作憑同皮陵反一本作馮依其身	commentary
不坼	勑宅反裂也	commentary
不副	孚逼反	commentary
重	直容反本又作種同	commentary
穋	音六本又作稑音同	commentary
稙	徴力反先種曰稙徐時力反韓詩曰長稼也	commentary
稺	音雉後種曰稺韓詩云幼稼也	commentary
菽麥	音叔大豆也	commentary
卑民	必爾反本又作俾下皆同	_
長大	張丈反	commentary
有秬	音巨黒黍也	commentary
纉禹	子管反繼也	commentary
粒食	音立	commentary
大王	音泰後大王大平皆同	source
翦商	子踐反毛齊也鄭斷也	commentary
斷也	音短下同	_
自豳	彼貧反	commentary
王迹	于況反	commentary
之屆	音戒極也	_
無貳	音二	commentary
屆極	紀力反下同	_
虞度	待洛反下同	commentary
無復	扶又反	commentary
敦商	鄭都回反治也注同王徐都門反厚也	commentary
又與	音預	commentary
東藩	方元反	commentary
乃筴	初革反	_
令專	力呈反	source
匪解	音懈	commentary
不忒	他得反	source
騂	息營反赤色也	commentary
犧	許冝反純毛牲	commentary
楅衡	音福逼也	commentary
犧尊	鄭素河反毛云有沙飾則冝同鄭王許冝反尊名也	source
將將	七羊反	commentary
毛炰	蒲包反	source
胾	側吏反肉也	commentary
羹	音庚又音衡	commentary
洋洋	音羊徐音翔衆多貌	commentary
不禴	羊灼反	_
秋祫	咸夾反	source
以楅	音逼	commentary
有沙	素河反刻鳳皇於尊其羽形婆娑然也一云畫也	source
豚也	字又作㹠徒門反	_
鈃羹	字又作鉶音刑	_
爲其	于僞反	commentary
觝	都禮反	source
有橫	古曠反一音光	_
有柎	方于反	_
爾熾	尺志反	commentary
僭踰	子念反	_
千乗	繩證反注千乗同	commentary
朱英	如字徐於耕反矛飾也	commentary
緑縢	徒登反繩也	commentary
重弓	直龍反注同	commentary
鬯中	勑亮反弓衣也字或作韔同	commentary
貝胄	直又反	source
朱綅	息廉反說文云綫也沈又倉林反又音侵	commentary
烝徒	之升反	source
増増	如字	commentary
綴之	沈知稅反又張劣反	commentary
艾也	音刈	_
台背	他來反下音貝	commentary
而艾	五蓋反	commentary
中時	張仲反	source
而重	直用反	commentary
大山	音泰本又作泰下注大室皆同	_
遂荒	如字毛有也鄭奄也韓詩作荒云至也	commentary
近海	附近之近	commentary
鳧	音符山名	commentary
繹	音亦一音夕字又作嶧同山名也	commentary
蠻貃	字又作貉武伯反	commentary
夷行	下孟反	commentary
應辭	應對之應	commentary
純嘏	古雅反	commentary
魯朝	直遥反	commentary
在	字又作薛息列反	commentary
是與	音余	commentary
兒齒	五兮反齒落更生細者也字書作齯音同一音如字	source
爲之	于僞反	commentary
祝慶	之又反下同	source
是斷	音短	source
是度	待洛反	source
松桷	音角榱也方曰桷	commentary
有舄	音昔大貌徐又音託	commentary
奕奕	音亦	commentary
榱也	色追反	_
其姣	古卯反	_
屬功	音燭	commentary
孔曼	音萬長也	commentary