定公上	定公名宋襄公之子昭公之弟諡法安民大慮曰定	_
第二十七杜氏盡七年經元年仲幾	音機	_
大雩	音于	source
煬宫	羊讓反	commentary
禱之	丁老反	_
隕霜	于敏反	_
殺叔	本或作菽音同	_
傳元年涖政	音利又音類	_
奸義	音干	_
大咎	其九反	_
屬役	之欲反	_
原壽過	古禾反	_
荒蕪	音無	_
近吳	附近之近	_
去其	起吕反注同	_
柏椁	音郭	_
庚寅栽	才代反又音再注同	_
薛郳	五兮反小邾國	_
爲夏	戸雅反注同	_
于邳	皮悲反	_
仲虺	許鬼反	_
左相	息亮反	_
薛焉	於䖍反	_
納侮	亡甫反	_
過分	扶問反	_
故復	扶又反	_
萇弘	直良反	commentary
旣厭	於豔反	_
其祚	才故反	_
亟言	起冀反	_
不中	丁仲反	_
故朝夕	如字	_
羈未	居冝反子家子名	_
得見	賢遍反下同	_
而從君	才用反注義從同又如字下從君從公放此	_
守龜	手又反	_
壞隤	徐音懷又戸怪反下徒回反	_
如闞	口暫反	_
惡昭	烏路反又如字	_
鴐鵞	音加下五何反	_
自旌	音精	_
惡之	如字又烏路反	commentary
將焉	於䖍反	commentary
鞏簡	九勇反	commentary
而好	呼報反	commentary
經二年兩觀	古亂反注及下同	_
囊瓦	乃郎反	source
傳二年爲我	于僞反注及下同	_
見舟	賢遍反	commentary
夷射姑	音亦一音夜	commentary
􁆻	音昬守門人也	_
以敲	苦孝反又苦學反說文作𫾣云擊頭也字林同又一曰擊聲也口交反又口卓反訓此𫾣云橫撾也又或作茅或作刜口交反	commentary
經三年子穿	音川	_
子拔	皮八反	_
傳三年臨廷	音庭下同	_
缾水	歩丁反本又作瓶	source
鑪	力吳反	commentary
炭	他且反	source
隋也	徒火反	commentary
先葬	息薦反又如字	source
五乗	繩證反	commentary
殉五人	辭俊反	commentary
藏中	才浪反	commentary
卞急	皮彦反	commentary
而好	呼報反下文及注同	commentary
躁疾	早報反	source
于郯	音談	commentary
肅爽	上如字又所六反下音霜肅爽駿馬名	commentary
駿馬	音俊	commentary
先從	才用反下同	commentary
飲先	於鴆反	commentary
自拘	九于反	commentary
弄馬	魯貢反	commentary
請相	息亮反注同	commentary
夫人	音扶注同	commentary
以償	市亮反	source
不共	音恭注同	commentary
而沈	音鴆	source
若復	扶又反	source
爲質	音致	source
經四年國夏	戸雅反	_
召陵	上照反	source
楚竟	音境	commentary
公孫生	本又作姓音生	_
皐鼬	由又反	_
復稱	扶又反	commentary
異處	昌慮反	commentary
伯成	音城	source
劉卷	音權一音眷勉反	source
劉蚠	扶粉反	source
爲告	于僞反下吳爲蔡同	commentary
孔圉	魚吕反	commentary
皆陳	直覲反	source
死難	乃旦反	source
并數	所主反	source
惡之	烏路反	source
傳四年水潦	音老	_
疾瘧	魚略反	commentary
祗取	音支	_
羽旄	音毛	commentary
析羽	星歷反下放此	commentary
或旆	歩貝反	_
旐	音兆	_
令賤	力呈反下欲令蔡同	_
嘖有	仕責反至也一音責	source
忿爭	爭鬪之爭	source
祝佗	徒河反	commentary
從	才用反下師從旅從同	source
大祝	音泰下大祝大卜大史大原同	commentary
共二	音恭注同	commentary
徼大	古堯反	source
且夫祝	音扶	commentary
出竟	音境下同	commentary
祓社	音弗徐音廢	source
釁鼓	許靳反	source
鼓鞞	歩西反本又作鼙	_
以從	如字又才用反	commentary
嘉好	呼報反	source
將長	丁丈反	commentary
欲令	力呈反	source
先衞	悉薦反下文先衞同	_
歃也	所洽反又所甲反	_
以蕃	方元反	_
相王	悉亮反	commentary
分魯公	扶問反下並同	source
大輅	音路本亦作路大輅金路也下皆同	_
大旂	其依反交龍爲旂諸侯所建	commentary
錫	星歷反錫同姓也	commentary
夏后	户雅反下音同	commentary
之璜	音黄美玉名	commentary
封父	音甫下武父同封父國名	source
繁弱	扶元反繁弱弓名	commentary
索	素洛反下同	source
長勺	市灼反下同	commentary
輯其	音集又七入反	commentary
共魯	音恭下文以共王職同	commentary
倍敦	本亦作陪同歩回反	_
典莢	本又作冊亦作䇿或作笧皆初革反	_
彞器	羊之反	commentary
迸散	彼諍反	commentary
皆令	徐力呈反	source
少皡	詩照反注及下同下胡老反	_
之虚	起居反注及下皆同	commentary
綪	七見反	commentary
茷	歩貝反又音吠	commentary
旃旌	章然反	commentary
陶氏	徒刀反	source
繁氏	歩河反	source
錡氏	魚綺反	source
封畛	之忍反一音眞	source
甫田	布五反本亦作圃同	commentary
塗所徑	音徒下音經	source
鄭藪	素口反	_
蓋近	附近之近下近戎同	source
相土	息亮反	commentary
東蒐	所求反	commentary
巡守	手又反	source
耼季	乃甘反	source
疆以	居良反注及下同	commentary
闕鞏	九勇反甲名	source
沽洗	鍾名上音孤下音息典反	commentary
之長	丁丈反下文乃長䘙同	source
惎	音忌毒也	source
閒王	閒厠之閒	_
道紂	音導	source
蔡蔡叔	上素達反放也注同下蔡叔如字	source
七乗	繩證反	commentary
改行	下孟反	commentary
見諸	賢遍反	source
之昭	上饒反說文作紹	source
伯甸	徒練反	commentary
晉重	直龍反	commentary
鄭捷	在接反	commentary
齊潘	普安反	commentary
宋王臣	如字本或作壬如林反	source
玆丕	普悲反	_
可覆	芳服反	commentary
弘說	音恱	commentary
爲之	于僞反下楚爲沈同	source
臨	力鴆反	source
黃父	音甫	commentary
語我	魚據反	commentary
無怙	音户	commentary
無敖	五報反	source
無復怒	扶又反重也注同	commentary
伍貟	音云	commentary
州犂	力兮反	commentary
嚭	普鄙反	commentary
子乾	其連反	source
爲質	音致	source
舎舟	音赦置也又音捨弃也注同	source
淮汭	人銳反	source
夾漢	古洽反	commentary
㳂漢	恱全反	source
上下	時掌反注同	commentary
遮使	正奢反	source
大隧	音遂	commentary
冥	亡丁反本或作寘之豉反	source
阨	於懈反本或作隘音同	commentary
惡子	烏路反	source
而好	呼報反	source
而陳	直覲反下文及注同	source
江夏	戸雅反	commentary
難而	乃旦反	source
其卒	子忽反下同	source
其乗	繩證反	commentary
廣死	古曠反	source
雍澨	市制反	commentary
季芈	面彌反楚姓	commentary
畀我	必利反世族譜季芈畀我皆平王女也服云畀我季芈之字	_
渉睢	七餘反下同	commentary
鍼尹	之林反	source
燧象	音遂火燧以繫象尾	source
被創	初良反	commentary
吳句	古侯反	_
剄而	古頂反	source
裹之	音果	commentary
雲夢	如字又音蒙	source
中肩	丁仲反	commentary
奔鄖	音云	source
以從	才用反下同一音如字	source
將殺	如字又申志反下我殺同	source
蔓成	音萬	commentary
不茹	音汝	commentary
矜寡	古頑反	commentary
非知	音智	source
殺女	音汝	commentary
其衷	音忠	source
又竄	七亂反	source
竄匿	女力反	source
施及	以豉反	commentary
之辟	匹亦反	source
若難	乃旦反	commentary
楚竟	音境	source
鑢金	音慮氏也金名本又作鑪	commentary
使見	賢遍反下注敢見同	commentary
以約	如字又於妙反	commentary
申包	必交反	commentary
以荐	在薦反	source
荐數也	所角反	source
草茅	舊作茅亡交反今本多作莽莫蕩反下同	_
無厭	於鹽反	source
疆	居良反	source
埸	音亦	source
逮吳	音代	_
取分	扶問反	commentary
勺飲	市灼反又音灼	commentary
爲之	于僞反	source
同仇	音求	commentary
經五年傳五年周亟	紀力反注同	_
行東野	下孟反下桓子行同	commentary
璵	本又作與音餘	commentary
璠	音煩又方煩反	source
斂	力驗反	commentary
當去	起吕反	commentary
不狃	女九反	commentary
彼爲	于僞反注同	commentary
子洩	息列反	commentary
使僭	子念反	_
逆勞	力報反下同	commentary
時從	才用反下從父昆弟皆從王並同	commentary
百乗	繩證反注同	source
于沂	魚依反	source
薳射	食亦反又食夜反	source
散卒	子忽反	source
堂谿	芳兮反下同	source
居麇	九倫反下同	commentary
暴骨	歩卜反	commentary
以歆	許金反	source
闉	音因	commentary
輿	音餘本又作與羊汝反	source
輿罷	音皮	commentary
復失	扶又反	_
葉公	舒渉反	source
從其母	如字又才用反	source
公父	音甫	source
公何藐	亡角反一音彌小反	source
大詛	莊慮反	source
父歜	昌欲反	source
秦遄	市專反	source
焉能	於䖍反	source
成臼	其九反	source
聊屈	其勿反又君勿反	source
藍尹	力甘反	source
亹	亡匪反	source
其帑	音奴	source
舎	音捨又音赦	commentary
謀殺	申志反	_
大難	乃旦反	commentary
爲君	于僞反下爲身同	commentary
無厭	於鹽反	commentary
逺丈	于萬反	commentary
以妻	七細反	commentary
脾洩	婢支反下息列反脾洩地名	commentary
袒而	音但	source
經六年祁犂	力兮反又力之反	_
公爲	于僞反	commentary
圍鄆	音運	source
經六年爲晉	于僞反注同	_
儋翩	丁甘反下音篇	commentary
豚澤	杜孫反	commentary
嬖大夫	必計反	source
之難	乃旦反	commentary
盤鑑	盤又作鞶歩丹反又蒲官反下古暫反	_
爲質	音致注同	commentary
大姒	音泰下音似	commentary
鄭俘	芳夫反	commentary
強使	其丈反注同下放此	_
不復	扶又反	source
其釁	許靳反	commentary
爲之	于僞反	commentary
欲令	力呈反	commentary
終纍	力追反又力軌反	commentary
夫差	音扶下初佳反	commentary
小惟子	位悲反本又作帷亦如字	source
之帥	所類反	source
大惕	他歷反	commentary
於鄀	音若	source
此見	賢遍反下文見溷并注同	commentary
爲戍	于僞反下同	source
今使	所吏反	source
其憾	戸暗反	source
說子	音恱	source
有難	乃旦反下文同	source
見溷	侯温反又侯困反	source
飲之	於鴆反	commentary
楊楯	食允反又音允	source
賈禍	音古	source
爲國	于僞反下同	commentary
越疆	居良反	source
而使	所吏反下同	commentary
比趙	毗志反	source
亳社	歩各反	commentary
詛于	側慮反	source
五父	音甫	commentary
之衢	其俱反	source
姑蕕	音由又作猶一音由舊反	source
單劉	音善	source
經七年于鹹	音咸	_
非使	所吏反	commentary
于沙	如字又星和反	source
傳七年中貳	丁仲反	_
復黨	扶又反	source
瑣	素果反	source
渉佗	徒何反	_
捘	子對反	source
公斂	力檢反又音廉或音慮點反	commentary
墮伏	許規反	source
而女	音汝下文同	source
苫荑	始占反	_
於難	乃旦反	source
黨氏	音掌	source