哀上	哀公名蔣定公之子蓋夫人定姒所生敬王二十八年即位謚法恭仁短折曰哀	source
第二十九杜氏盡十三年經元年得見	賢遍反下同	_
此復	扶又反	commentary
一處	昌慮反	source
傳元年而栽	才代反又音再注同說文云築牆長版	_
圍壘	力軌反	commentary
周帀	子合反	source
廣丈	古曠反	source
髙陪	並如字髙又古報反注同	_
厚一	戸豆反	source
夫屯	徒門反夫兵也屯守也	commentary
故令	力呈反	source
以辨	扶免反又方免反別也	commentary
別也	彼列反下同	_
係纍	力維反	commentary
出降	戸江反	commentary
使疆	居良反	commentary
夫椒	音扶椒又作椒子消反	commentary
檇李	音醉	commentary
大湖	音泰	commentary
甲楯	食允反又音允	commentary
會稽	古外反下古兮反㑹稽山名	_
上會稽	時掌反	_
大夫種	章勇反	commentary
大宰	音泰	source
嚭	普鄙反	commentary
伍貟	音雲	source
去疾	起吕反本又作去惡	source
有過	古禾反國名注及下同	commentary
澆	五呌反一音五報反下同	commentary
殺斟	之林反	commentary
灌	古亂反	commentary
斟鄩	音尋	commentary
寒促	仕捉反	_
夏同姓	戸雅反下注皆同	commentary
夏后相	息亮反注及下注同	commentary
復爲	扶又反	source
后緡	亡巾反	_
昬忘	亡亮反	_
方娠	音震又音身懷妊也	commentary
自竇	音豆	commentary
少康	詩照反	commentary
之長	丁丈反	commentary
惎澆	音忌毒也	commentary
庖正	歩交反	source
妻之	七計反注同	commentary
二姚	羊昭反虞姓也	source
諸綸	音倫	commentary
有鬲	音革	source
之燼	徐刃反又秦刃反	commentary
女艾	上如字又音汝下五蓋反	source
諜澆	音牒	commentary
季杼	直吕反	commentary
誘豷	許器反	commentary
過戈	並古禾反	commentary
之績	一本作迹	commentary
吳難	乃旦反	_
務施	始豉反下同	source
而長	丁丈反下同	commentary
可竢	本又作俟音仕待也	_
介在	音界	commentary
求伯	如字又音霸	commentary
生聚	才喻反又如字	commentary
爲沼	之兆反池也	commentary
汙池	音烏	source
故復	扶又反	commentary
邯鄲	音寒下音丹	commentary
逢滑	于八反	commentary
土芥	古邁反草也	commentary
不艾	魚廢反	commentary
暴骨	歩卜反	commentary
如莽	亡黨反	commentary
孔圉	魚吕反	source
烝鉏	之承反下仕居反	commentary
不重	直龍反	commentary
崇壇	徒丹反	commentary
不彤	徒冬反丹漆也	commentary
鏤	魯豆反刻也	commentary
不觀	古亂反注同	commentary
臺榭	音謝	commentary
取費	芳味反	source
天有葘	音災	_
癘	本或作天無葘癘非	source
疾疫	音役	source
而共	音恭	source
熟食者分	如字一讀以分字連下句	source
猶徧	音遍	commentary
卒	子忽反	commentary
乗	繩證反	commentary
與焉	音預	commentary
不罷	音皮	source
陂池	彼冝反	commentary
妃嬙	本又作廧或作牆在羊反	commentary
嬪御	毗人反	commentary
玩好	呼報反	commentary
夫先自敗也巳	夫音扶本或作夫差先自敗者非	source
經二年取漷	火虢反又音郭	_
及沂	魚依反	commentary
易也	以豉反	commentary
句繹	古侯反下音亦	source
以要	一遥反	commentary
于鐵	尺結反	source
皆陳	直覲反	source
傳二年伐絞	古卯反	_
郢也	以井反	commentary
立女	音汝	commentary
三揖	一入反三揖卿大夫士也	source
祇辱	音支	_
立適	丁歷反下適孫同	source
大子絻	音問喪冠也	source
衰絰	七雷反下田結反	source
子般	音班	commentary
先陳	直覲反下注同	commentary
爰契	苦計反又苦結反	source
謀協以故兆	絶句	source
詢可也	思遵反	source
斬艾	魚廢反	commentary
欲擅	市戰反	source
而滅其君	滅或作戕音殘	source
除詬	呼豆反又音苟	source
作雒	音洛	_
千里百縣	縣方百里	source
縣有四郡	郡方五十里	source
斯役	如字字又作厮音同何休注公羊云艾草爲防者曰厮汲水漿者曰役蘇林注漢書云厮取薪者韋昭云析薪曰厮	_
志父	音甫杜云志父趙簡子之改名也服云趙鞅入晉陽以畔後得歸改名志父春秋仍舊猶書趙鞅	source
絞縊	一賜反	source
以戮	音六	source
桐棺三寸	禮記云夫子制於中都四寸之棺五寸之椁以斯知不欲速朽也鄭康成注云此庶人之制也案禮上大夫棺八寸屬六寸下大夫棺六寸屬四寸無三寸棺制也棺用難朽之木桐木易壞不堪爲棺故以為罰墨子尚儉有桐棺三寸	commentary
不設屬	音燭注同次大棺也	source
辟	歩歴反注同親身棺也禮大夫無辟	source
之重	直龍反下同	commentary
王棺四重	禮記云水兕革棺被之其厚三寸杝棺一梓棺二杝棺辟也梓棺二屬與大棺也被水牛及兕之革為一重辟為二重屬為三重大棺為四重	source
君再重	君謂侯伯子男侯伯已下無革棺屬與辟為一重大棺為再重上公則唯無水革耳兕革與辟為一重屬為再重大棺為三重	commentary
大夫一重	大夫唯屬與大棺為一重今云不設辟者時僭耳非正禮也	source
樸馬	普卜反	commentary
載柩	其又反	commentary
為衆	于偽反	_
郵無恤	音尤	commentary
其怯	去業反	source
百乘	繩證反	_
牖下	羊九反	commentary
麇之	丘隕反麇束縛也注同	commentary
吏詰	起吉反	_
痁作	詩占反瘧疾也	_
瘧疾	魚畧反	_
禱曰	丁老反一音丁報反	_
在難	乃旦反下注為難同	_
自佚	音逸	_
持矛	亡侯反	_
絶筋	居銀反	_
中肩	丁仲反	_
斃于	婢世反本亦作弊	_
踣	蒲北反	_
蠭旗	芳恭反旗名	_
復伐	扶又反	_
傅傁	素口反又作叟	_
有知	音智	_
未艾	魚廢反又五盖反	_
公孫尨	武江反	_
稅焉	始銳反	_
為范	于僞反下文爲其主同	_
幕下	音莫	commentary
姚般	子姚子般	_
林殿	丁見反	_
而射	食亦反	_
伏􁂥	吐刀反弓衣也	_
嘔血	本又作􁒙烏口反吐也	_
吐也	他露反	_
兩靷	以刃反	_
洩庸	息列反一音作息引反未詳	_
中悔	丁仲反	_
經三年曼姑	音萬	_
爲子	于僞反	commentary
樂髠	苦孫反	_
傳三年司鐸	待洛反	_
南宫閱	音恱	_
曰庀	匹婢反具也	_
女	音汝	commentary
命不共	音恭	commentary
校人	戸敎反注及下同	commentary
乗馬	繩證反注及下皆同	source
脂轄	戸瞎反本又作鎋同	commentary
爲駕	于僞反	source
之易	以豉反	commentary
變難	乃旦反	source
濟濡	子細反又子禮反注同	source
帷幕	位悲反下音莫	source
鬱攸	音由鬱攸火氣也	source
蒙葺	七入反一音丁入反	commentary
以悛	七全反次也	commentary
縣敎	音玄	_
富父	音甫	commentary
槐	音懷	commentary
官辦	辦具之辨注同	source
猶拾	音十	commentary
瀋也	尺審反汁也北土呼汁爲瀋	source
去表	起吕反注同	commentary
之稾	古老反注同	_
所郷	許亮反	_
稾積	子賜反	_
道還	本又作環尸關反又音患注同	source
勑令	力呈反	commentary
南孺子	如住反	commentary
共劉	音恭	commentary
其郛	芳夫反	commentary
惡范氏	烏路反注同	source
經四年盜殺	申志反	_
蔡侯申	今本皆如此案宣十七年蔡侯申卒是文侯也今昭侯是其玄孫不容與髙祖同名未詳何者誤	commentary
公孫姓	音生本又作生或一音性	source
恥爲	于僞反	commentary
亳社	歩洛反	commentary
頃公	音傾	commentary
傳四年也承	音懲直升反	_
公孫翩	音篇	commentary
而射	食亦反下同	commentary
文之鍇	音楷又音皆又客駭反	source
併行	歩頂反	commentary
中肘	丁仲反下竹九反	source
公孫盱	況于反	commentary
眅	普版反字林匹姦反	commentary
葉公	始渉反	commentary
負函	音咸	source
繒關	才陵反	commentary
泝江	音素	source
入郢	以井反又以政反	source
單浮餘	音善	commentary
氏潰	戸内反	source
陸渾	戸門反	source
豐析	星歷反注同	commentary
菟和	音徒	commentary
監尹	古銜反	source
少習	詩照反又如字少習即武關也	source
之難	乃旦反	source
將爲	于僞反下注同	source
以畀	必利反與也	_
楚復	扶又反	commentary
甯跪	其委反	_
邯鄲降	戸江反	commentary
遂墮	許規反	commentary
取邢	音刑	commentary
任	音壬	commentary
欒	力官反	commentary
鄗	呼洛反郭璞三蒼解詁音􁂄字林火沃反韋昭呼告反闞駰云讀磽确同	commentary
逆畤	音止	commentary
盂	音于	source
經五年城毗	頻夷反	_
杵臼	昌吕反下求又反	source
傳五年惡張	烏路反下同	_
柳朔	良久反	commentary
夫非	音扶	commentary
好不	呼報反	commentary
不去	起吕反	commentary
以僭	子念反後同	source
爲吉射	于僞反	_
燕姬	於賢反	source
未冠	古喚反	source
鬻姒	音育下音似	source
子荼	音舒又音徒又丈加反	commentary
嬖	必計反	source
齒長	丁丈反	source
閒於	音閑又音閒廁之閒又如字	_
疾疢	勑覲反本或作疹乃結反	source
謀樂	音洛	commentary
寘羣	之豉反羣或作諸	source
於萊	音來	source
公子黔	巨廉反又音琴	source
公子鉏	仕居反	source
不與	音預下同	source
埋	亡皆反	commentary
而侈	昌氏反又尸氏反	commentary
惡而	烏路反	source
不解	佳賣反	commentary
攸曁	許器反息也	_
鮮矣	息淺反	source
不濫	力暫反	commentary
濫溢	音逸	commentary
經六年邾瑕	音遐	_
任城	音壬	commentary
亢父	苦浪反又音剛下音甫	commentary
廢長	丁丈反	commentary
立少	詩照反	commentary
于柤	莊加反	commentary
楚子軫	之忍反史記作珍	commentary
殺荼	音試下皆同	commentary
傳六年復脩	扶又反	_
城父	音甫	commentary
驂乗	繩證反	source
偃蹇	約免反下紀晚反	commentary
驕敖	五報反	source
必偪	音逼	commentary
盍	戸臘反下同	commentary
去諸	起吕反下同	commentary
需	音須疑也一音懦懦弱持疑也	source
多難	乃旦反	source
鮑牧	州牧之牧	commentary
乗如	繩證反	source
晏圉	魚吕反	commentary
五辭	本又作辤說文辭不受也受辛冝辭也辝籀文	source
大冥	亡丁反	commentary
舎其	音捨	commentary
夾日	古洽反	source
大史	音泰下同	source
若禜	音詠	source
禳祭	如羊反	commentary
而寘	之豉反	source
其夭	於表反	_
又焉	於䖍反	commentary
爲祟	息遂反	source
竟内	音境	source
睢	七餘反	commentary
漳	音章	source
楚昭王知大道矣	本或作天道非	source
夏書	戸雅反下注同此語在尚書五子之歌書無帥彼天常一句下亦微異	source
其行	如字又下孟反尚書作厥道	commentary
乃滅而亡	尚書作乃厎滅亡	commentary
且于	子餘反	commentary
上乗	繩證反	source
闞止	苦暫反	commentary
壬也	而林反	commentary
洩言	息列反又以製反	commentary
欲令	力呈反下同	source
與饋	其位反	source
差車	所冝反	commentary
鮑點	之廉反又如字	commentary
女忘	音汝	commentary
而折	之舌反又市列反注同	commentary
而背	音佩後年皆同	commentary
故要	一遥反	source
去鬻	起吕反	source
拘	音俱	source
江說	音恱	source
句竇	音鉤下音豆	source
不匱	其位反	commentary
多難	乃旦反	commentary
少君	詩照反	commentary
長君	丁丈反	commentary
夫􁅈子	音扶􁅈或作孺同	_
於駘	他才反又徒來反	commentary
野幕	音莫	commentary
殳	音殊	commentary
冒	亡報反	commentary
淳	音純	commentary
駐於	中住反	commentary
經七年皇瑗	于眷反	_
于繒	才陵反一本作鄫	_
傳七年百牢	力刀反	_
吳過宋	古禾反	_
以後	如字又戸豆反	source
上物	如字一音時掌反注同	commentary
道長	丁丈反注及下注同	source
旣共	音恭	commentary
大伯	音泰注同	commentary
斷髮	丁管反	commentary
臝以	本又作倮力果反	commentary
故效	戸孝反	commentary
將焉	於䖍反	commentary
惡賢	音烏安也注同	source
無數	所主反	commentary
不樂	音岳一音洛	source
不禦	魚吕反	commentary
擊柝	音託以兩木相擊以行夜也字又作柝同	source
聞於	音問又如字	commentary
晝掠	中救反下音亮	source
于繹	音亦	commentary
鄒縣	側留反	_
乗韋	繩證反下及注同	source
馮恃	皮冰反注同	commentary
辟	匹亦反注同	commentary
振鐸	待洛反注同	source
公孫疆	其良反	_
好田	呼報反下同	commentary
弋	以職反繳射也	commentary
田弋之說	如字	commentary
說之	音恱下大說同	commentary
彊言霸說	如字一音始銳反	commentary
而奸	音干	commentary
揖丘	音集一音於入反	commentary
鍾邘	音于	_
經八年褚師	中呂反	_
之詬	呼豆反	commentary
取讙	音歡	commentary
及闡	尺善反	commentary
伯過	古禾反	commentary
官使	所吏反	_
傳八年肥殿	丁練反下注同	_
詬之	本又作訽呼豆反詈辱也	commentary
詈辱	力智反	_
吳為	于偽反下注則為之隱惡同	_
不狃	女九反	source
死其難	乃旦反	commentary
曽所	在増反	source
且夫	音扶	commentary
之行	下孟反又如字	commentary
所惡	烏路反又如字注同	source
之好	呼報反下文好焉同	source
欲覆	芳服反	commentary
子泄	息列反又作洩	_
與斃	婢世反	commentary
子洩率	絶句	source
故道險	絶句	commentary
吳竟	音境	_
僑田	其驕反	source
拘鄫	音俱下同	source
之漚	烏豆反	source
菅	古顔反	source
水滋	音𤣥本亦作兹子絲反濁也字林云黑也	source
道之	音導	commentary
澹臺	待甘反	source
內應	應對之應	_
析朱鉏	星歷反注及下同	source
泗上	音四	source
私屬	音燭	commentary
於幕庭	亡博反	source
設格	更百反	commentary
令士	力呈反	source
試躍	羊灼反	commentary
與焉	音預注同	source
任行	音壬	source
三遷	息暫反	source
析骸	戸皆反本又作骨	source
而爨	七亂反	source
及虧	去危反	source
吳輕	遣政反	_
負載	如字謂載書或音戴	commentary
造於	七報反	commentary
萊門	音來	commentary
爲質	音致下同	source
復求	扶又反	commentary
妻之	七計反	source
魴侯	音房	source
前爲	于僞反	source
荐之	本又作栫在薦反	_
荐雍也	於勇反	_
使女	音汝	commentary
千乗	繩證反注及下同	source
故諷	方鳳反	source
愬之	音素	source
於潞	音路	commentary
麇之	丘隕反束縛也	source
經九年雍丘	於勇反	_
傳九年公孟綽	昌灼反本又作卓同	_
武子䞉	以證反	commentary
作壘	力軌反	commentary
塹成	七豔反	commentary
郟張	古洽反又音甲	source
城邗	音寒	_
射陽	食亦反又音亦	source
可游	音由	commentary
可馮	皮冰反	commentary
之需	音須	commentary
以祉	音恥	commentary
儆	音景	commentary
經十年不與	音預	_
書殺	申志反	_
孟彄	苦侯反	commentary
傳十年剡子	音談	_
于鄎	音息	source
兵并	必政反	commentary
人殺	申志反	commentary
襲重	直龍反又直用反	source
取犂	力兮反又力之反	commentary
及轅	音袁一音于眷反	source
名隰	音習本或作濕音同	commentary
來復	扶又反	commentary
壽夢	音蒙	commentary
少子	詩照反	commentary
經十一年轅頗	破可反又普多反	_
艾陵	五蓋反	commentary
公與伐	音預下同	commentary
傳十一年齊爲	于僞反	_
無丕	普悲反	_
一子守	手又反	source
從公	如字又才用反	source
御諸	魚吕反本又作禦	_
竟	音境注同	commentary
自度	待洛反	source
封疆	居良反注同	source
二子之不欲戰也冝	絶句	commentary
黨氏	音掌	commentary
強問	其丈反	_
而共	音恭	source
不成丈夫也	本或作大夫非	source
蒐乗	所求反下繩證反	commentary
閱	音恱	source
孟孺子	而住反	source
彘	直利反	source
邴洩	音丙又彼命反	commentary
管周父	音甫	_
年少	詩照反	commentary
徒卒	子忽反注同	commentary
雩門	音于	commentary
繇役	本或作徭同音遥	source
陳瓘	古喚反	commentary
渉泗	音四	commentary
爲殿	丁練反	commentary
抽矢	勑留反	commentary
䇿其	初革反本或作筴	source
誰不如	如字一音而庶反注同	source
惡賢	音烏注同	commentary
宵諜	音牒	source
齊人遁	徒困反	commentary
諜閒	閒廁之閒	_
語人	魚據反	source
能黙	本亦作嘿亡北反	commentary
其嬖	必計反	commentary
童	本亦作僮音同	commentary
汪	烏黃反	source
錡	魚綺反	source
乗	繩證反	source
無殤	音商八歳至十九爲殤	source
用矛	亡侯反	commentary
皆陳	直覲反	commentary
轅咺	況阮反	commentary
稻醴	音禮以稻米爲醴酒	commentary
粱糗	起九反糗乾飯也以粱米爲之一音昌紹反	_
腶脯	丁亂反字亦作鍜加薑桂曰脯也	_
爲郊	于僞反	commentary
于嬴	音盈	source
公孫夏	户雅反	source
虞殯	必刃反	commentary
陳子行	如字又戸郎反	commentary
具含玉	户暗反本又作唅	commentary
公孫揮	許韋反	source
問遺	唯季反	source
王卒	子忽反	source
八百乗	繩證反	commentary
兵從	才用反又如字	source
勞公	力報反	source
甲劒鈹	普悲反	commentary
寘之	之豉反	commentary
新篋	苦協反	commentary
褽以	音尉薦也一本作褽之以玄纁	source
玄纁	許云反本亦作勲	source
加組	音祖	commentary
不衷	音忠善也	commentary
饋賂	其位反或作餽下音路	commentary
是豢	音患養也	commentary
也夫	音扶	commentary
爲沼	之兆反	source
其泯	亡軫反	source
盤庚	歩干反	source
之誥	古報反	source
不共	音恭注同	source
則劓	魚器反	source
殄	大典反	source
無俾	必爾反	commentary
易種	章勇反注同	source
從橫	子容反	commentary
育長	丁丈反	commentary
使於	所吏反	commentary
屬其	音燭注及下同	source
屬鏤	力俱反又力侯反屬鏤劒名	source
墓檟	古雅反木名	source
脩守	手又反	commentary
子朝	如字	commentary
妻之	七計反	commentary
於犂	力兮反	commentary
孔姞	其乙反又其吉反	source
向魋	徒回反	commentary
於鄖	音云	commentary
少禘	詩照反下大計反	commentary
子憖	魚覲反一作整征領反	commentary
而飲	於鴆反	commentary
遂聘	匹政反	source
夏戊	戸雅反下同戊音茂	source
胡簋	音軌	source
遽止	其據反	source
度其	待洛反注及下同	source
之難	乃旦反	source
別其田	如字一音彼列反	commentary
施取	尸豉反	commentary
斂從	力豔反	source
貪冒	亡北反一音莫報反	source
無厭	於鹽反	source
經十二年諱取	七喻反又如字本或作娶	_
槖皐	章夜反或一音託	_
逡	音峻又七倫反	commentary
遒	音囚又音巡	source
繇	音遥	source
螽	音終	source
傳十二年取于	七喻反本亦作娶	_
與弔	音預注同	commentary
不絻	音問	commentary
放絰	大結反	commentary
故去	起吕反	source
奉贄	音至	commentary
以要	一遥反注同	source
尋重	直龍反	commentary
寒歇	許謁反	commentary
且姚	子餘反	source
之斃	婢世反	commentary
不摽	敷蕭反又普交反擊也	commentary
國狗	音茍	source
之瘈	吉世反狂也	commentary
噬也	市制反	source
齧	五結反本或作嚙	commentary
藩衞	方元反注及下同	_
籬也	力知反	_
歸餼	許氣反	source
以難	乃旦反注同	commentary
子盍	户臘反	source
不爲	于僞反	commentary
是墮	許規反注及下皆同	commentary
嚭說	音恱下同	commentary
乃舎	音捨釋也又音赦	source
效夷	戸敎反	commentary
蟄者	直立反	commentary
隙地	去逆反	commentary
閒田	音閑一本作閒地一音如字	_
彌作	亡支反又亡爾反	source
頃丘	苦潁反又音傾	commentary
玉暢	勑亮反一本作士暢	source
嵒	五咸反	commentary
戈	古禾反	source
錫	音羊一音星歷反	source
爲之	于僞反	source
今倒	丁老反	commentary
爲別	如字又彼列反	_
經十三年男成	音城本或作成	_
近濟	附近之近	source
自去	起吕反	commentary
其僭	子念反	source
星孛	歩内反	commentary
乃見	賢遍反	source
陳夏	戶雅反	source
區夫	烏侯反	source
故復	扶又反	commentary
傳十三年使徇	似俊反	_
成讙	火官反	commentary
郜延	古報反或古毒反	commentary
為虛	並如字或音墟非	_
單平公	音善	commentary
不與	音預	source
二隧	音遂注同道也	source
謳陽	烏侯反	commentary
自泓	烏宏反	commentary
姑蔑	亡結反	commentary
之旗	音其	source
大末	音㤗孟康云大音闥	commentary
屬徒	音燭注同	source
地守	手又反下注同	source
復戰	扶又反	source
王惡	烏路反注同	commentary
自剄	古頂反	source
爭歃	所洽反又所甲反	_
為長	丁丈反注下同	_
大伯	音泰	commentary
日旰	古旦反	source
徳輕	遣政反	_
見晉侯	如字又賢遍反	source
對使	所吏反	source
以見	賢遍反	source
於吳有豐	芳中反	_
八百乘	繩證反下及注同	_
六人從	才用反	source
户牖	音酉	_
坐為	才臥反	_
恐之	丘勇反	commentary
不共	音恭	source
而祇	音支	_
繠兮	而捶反又而水反	_
一盛	音成又市政反注同	source
與褐	戶葛反	source
之父	如字又音甫	source
睨之	五計反視也	commentary
麤則	本或作麄七奴反	source
以呼	火故反	commentary
殺其丈夫	直兩反本或作大夫誤	source
悖惑	補内反	source